Rk,Player,Nation,Pos,Squad,Age,Born,90s,Tkl,TklW,Def 3rd,Mid 3rd,Att 3rd,Tkl.1,Att,Tkl%,Lost,Blocks,Sh,Pass,Int,Tkl+Int,Clr,Err,Matches
1,Patrick van Aanholt,nl NED,DF,Crystal Palace,26,1990,24.3,47,32,29,15,3,16,34,47.1,18,24,5,19,47,94,64,2,Matches
2,Rolando Aarons,eng ENG,"MF,FW",Newcastle Utd,21,1995,1.5,4,4,3,1,0,4,6,66.7,2,3,0,3,1,5,0,0,Matches
3,Tammy Abraham,eng ENG,FW,Swansea City,19,1997,19.2,10,8,1,7,2,1,13,7.7,12,8,1,7,1,11,11,0,Matches
4,Charlie Adam,sct SCO,MF,Stoke City,31,1985,4.6,9,5,2,5,2,5,17,29.4,12,2,0,2,9,18,11,2,Matches
5,Adrián,es ESP,GK,West Ham,30,1987,19.0,2,1,2,0,0,1,4,25.0,3,1,0,1,0,2,15,1,Matches
6,Ibrahim Afellay,nl NED,MF,Stoke City,31,1986,1.8,3,3,0,3,0,1,2,50.0,1,1,0,1,1,4,1,0,Matches
7,Benik Afobe,cd COD,FW,Bournemouth,24,1993,6.8,4,3,1,2,1,1,6,16.7,5,4,0,4,0,4,6,0,Matches
8,Sergio Agüero,ar ARG,FW,Manchester City,29,1988,21.8,9,6,2,6,1,2,17,11.8,15,12,1,11,6,15,3,0,Matches
9,Nathan Aké,nl NED,DF,Bournemouth,22,1995,37.3,53,32,34,16,3,22,40,55.0,18,47,24,23,48,101,246,2,Matches
10,Marc Albrighton,eng ENG,"MF,FW",Leicester City,27,1989,28.2,52,33,16,29,7,16,52,30.8,36,32,4,28,27,79,34,0,Matches
11,Toby Alderweireld,be BEL,DF,Tottenham,28,1989,13.1,19,13,7,11,1,8,15,53.3,7,11,5,6,4,23,55,0,Matches
12,Trent Alexander-Arnold,eng ENG,DF,Liverpool,18,1998,17.5,37,25,23,9,5,22,36,61.1,14,20,5,15,28,65,46,1,Matches
13,Joe Allen,wls WAL,MF,Stoke City,27,1990,34.9,96,62,41,43,12,27,87,31.0,60,43,9,34,58,154,68,1,Matches
14,Dele Alli,eng ENG,"MF,FW",Tottenham,21,1996,32.9,46,30,15,21,10,8,34,23.5,26,33,7,26,19,65,22,1,Matches
15,Marcos Alonso,es ESP,"DF,MF",Chelsea,26,1990,31.7,51,33,30,18,3,23,44,52.3,21,36,5,31,47,98,76,1,Matches
16,Daniel Amartey,gh GHA,DF,Leicester City,22,1994,5.4,8,4,7,1,0,3,7,42.9,4,7,3,4,7,15,21,1,Matches
17,Ethan Ampadu,wls WAL,DF,Chelsea,16,2000,0.1,1,1,0,1,0,0,0,,0,0,0,0,0,1,2,0,Matches
18,Nordin Amrabat,ma MAR,FW,Watford,30,1987,2.2,6,3,1,5,0,1,3,33.3,2,1,0,1,0,6,2,0,Matches
19,Michail Antonio,jm JAM,"FW,MF",West Ham,27,1990,15.0,15,9,7,6,2,4,14,28.6,10,14,0,14,13,28,16,0,Matches
20,Scott Arfield,ca CAN,"MF,FW",Burnley,28,1988,14.8,36,26,20,13,3,19,44,43.2,25,22,1,21,11,47,24,0,Matches
21,Marko Arnautović,at AUT,"FW,MF",West Ham,28,1989,25.7,21,16,9,8,4,7,19,36.8,12,20,3,17,13,34,35,0,Matches
22,Harry Arter,ie IRL,MF,Bournemouth,27,1989,10.7,19,16,10,7,2,6,23,26.1,17,18,5,13,9,28,6,0,Matches
23,Christian Atsu,gh GHA,"FW,MF",Newcastle Utd,25,1992,19.8,17,16,10,7,0,7,20,35.0,13,35,5,30,13,30,27,1,Matches
24,Pierre-Emerick Aubameyang,ga GAB,FW,Arsenal,28,1989,11.7,5,4,3,2,0,1,7,14.3,6,14,1,13,3,8,7,0,Matches
25,Serge Aurier,ci CIV,DF,Tottenham,24,1992,15.9,48,27,27,13,8,11,31,35.5,20,20,1,19,31,79,54,1,Matches
26,Charlie Austin,eng ENG,FW,Southampton,28,1989,11.5,7,5,1,3,3,3,10,30.0,7,15,3,12,1,8,10,0,Matches
27,André Ayew,gh GHA,"MF,FW",West Ham,27,1989,9.9,19,14,6,10,3,6,19,31.6,13,5,0,5,4,23,3,0,Matches
28,André Ayew,gh GHA,"MF,FW",Swansea City,27,1989,10.6,15,10,3,10,2,2,13,15.4,11,13,1,12,5,20,8,0,Matches
29,Jordan Ayew,gh GHA,"FW,MF",Swansea City,25,1991,31.7,82,60,20,35,27,15,54,27.8,39,43,3,40,24,106,20,1,Matches
30,César Azpilicueta,es ESP,DF,Chelsea,27,1989,37.0,80,59,47,26,7,27,54,50.0,27,48,22,26,54,134,135,1,Matches
31,Eric Bailly,ci CIV,DF,Manchester Utd,23,1994,11.1,17,10,10,5,2,5,12,41.7,7,11,6,5,25,42,58,1,Matches
32,Leighton Baines,eng ENG,DF,Everton,32,1984,21.2,25,13,18,3,4,9,14,64.3,5,18,6,12,25,50,56,0,Matches
33,Tiemoué Bakayoko,fr FRA,MF,Chelsea,22,1994,23.6,64,41,25,32,7,16,48,33.3,32,23,6,17,37,101,38,4,Matches
34,Sam Baldock,eng ENG,FW,Brighton,28,1989,0.4,0,0,0,0,0,0,0,,0,0,0,0,0,0,0,0,Matches
35,Beni Baningime,cd COD,MF,Everton,18,1998,2.2,6,2,1,2,3,0,4,0.0,4,5,1,4,2,8,2,0,Matches
36,Phil Bardsley,sct SCO,DF,Burnley,32,1985,12.5,17,16,9,7,1,4,11,36.4,7,22,6,16,22,39,77,0,Matches
37,Ross Barkley,eng ENG,MF,Chelsea,23,1993,1.4,0,0,0,0,0,0,1,0.0,1,3,1,2,0,0,2,0,Matches
38,Ashley Barnes,eng ENG,FW,Burnley,27,1989,24.1,21,14,1,14,6,5,29,17.2,24,26,5,21,2,23,19,0,Matches
39,Harvey Barnes,eng ENG,"MF,FW",Leicester City,19,1997,0.1,0,0,0,0,0,0,0,,0,0,0,0,0,0,0,0,Matches
40,Gareth Barry,eng ENG,MF,West Brom,36,1981,21.4,35,19,17,14,4,15,45,33.3,30,19,11,8,14,49,34,0,Matches
41,Kyle Bartley,eng ENG,DF,Swansea City,26,1991,2.6,3,2,3,0,0,2,2,100.0,0,6,6,0,4,7,21,0,Matches
42,Michy Batshuayi,be BEL,FW,Chelsea,23,1993,4.0,5,4,2,3,0,1,3,33.3,2,0,0,0,1,6,3,0,Matches
43,Moritz Bauer,at AUT,"DF,MF",Stoke City,25,1992,14.5,24,17,17,7,0,10,26,38.5,16,9,1,8,12,36,48,0,Matches
44,Jan Bednarek,pl POL,DF,Southampton,21,1996,4.7,6,3,6,0,0,3,6,50.0,3,2,1,1,5,11,27,0,Matches
45,Asmir Begović,ba BIH,GK,Bournemouth,30,1987,38.0,0,0,0,0,0,0,2,0.0,2,0,0,0,2,2,16,7,Matches
46,Héctor Bellerín,es ESP,DF,Arsenal,22,1995,33.9,57,43,36,12,9,25,52,48.1,27,42,8,34,23,80,89,4,Matches
47,Yohan Benalouane,tn TUN,DF,Leicester City,30,1987,1.0,7,3,6,1,0,4,6,66.7,2,1,1,0,1,8,4,0,Matches
48,Christian Benteke,be BEL,FW,Crystal Palace,26,1990,24.9,11,4,3,7,1,2,17,11.8,15,15,3,12,3,14,44,0,Matches
49,Saido Berahino,bi BDI,FW,Stoke City,23,1993,5.5,2,2,0,1,1,0,1,0.0,1,4,1,3,1,3,2,0,Matches
50,Jóhann Berg Guðmundsson,is ISL,MF,Burnley,26,1990,31.5,43,27,16,19,8,20,47,42.6,27,21,1,20,34,77,43,0,Matches
51,Ryan Bertrand,eng ENG,DF,Southampton,27,1989,34.8,48,35,27,17,4,19,31,61.3,12,28,9,19,44,92,74,0,Matches
52,Muhamed Bešić,ba BIH,MF,Everton,24,1992,0.5,1,1,1,0,0,1,3,33.3,2,2,2,0,0,1,1,0,Matches
53,Philip Billing,dk DEN,MF,Huddersfield,21,1996,8.5,25,16,11,11,3,8,22,36.4,14,17,1,16,18,43,19,0,Matches
54,Mame Biram Diouf,sn SEN,"FW,DF",Stoke City,29,1987,28.8,48,36,26,15,7,8,21,38.1,13,22,0,22,14,62,76,1,Matches
55,Daley Blind,nl NED,"DF,MF",Manchester Utd,27,1990,4.0,6,4,3,2,1,2,7,28.6,5,3,0,3,7,13,14,0,Matches
56,Jeremie Boga,ci CIV,MF,Chelsea,20,1997,0.2,0,0,0,0,0,0,0,,0,0,0,0,0,0,0,0,Matches
57,Yannick Bolasie,cd COD,FW,Everton,28,1989,9.5,8,7,4,1,3,2,7,28.6,5,5,0,5,4,12,8,0,Matches
58,Gaëtan Bong,cm CMR,DF,Brighton,29,1988,24.8,39,32,25,11,3,15,26,57.7,11,24,6,18,40,79,81,1,Matches
59,Wilfried Bony,ci CIV,FW,Swansea City,28,1988,7.9,5,4,2,2,1,1,5,20.0,4,4,1,3,2,7,15,0,Matches
60,Sofiane Boufal,ma MAR,"FW,MF",Southampton,23,1993,13.5,37,24,12,14,11,12,35,34.3,23,20,1,19,6,43,6,0,Matches
61,Robbie Brady,ie IRL,MF,Burnley,25,1992,14.2,32,21,14,17,1,8,28,28.6,20,17,3,14,7,39,29,0,Matches
62,Claudio Bravo,cl CHI,GK,Manchester City,34,1983,2.5,0,0,0,0,0,0,1,0.0,1,0,0,0,0,0,0,0,Matches
63,Miguel Britos,uy URU,DF,Watford,32,1985,8.9,15,11,10,5,0,6,11,54.5,5,9,1,8,12,27,45,1,Matches
64,Leon Britton,eng ENG,MF,Swansea City,34,1982,3.4,6,5,0,5,1,5,8,62.5,3,3,1,2,1,7,1,0,Matches
65,Izzy Brown,eng ENG,"MF,FW",Brighton,20,1997,3.5,3,3,2,1,0,1,7,14.3,6,3,0,3,1,4,3,0,Matches
66,Bruno,es ESP,DF,Brighton,36,1980,22.4,30,17,21,6,3,14,22,63.6,8,17,11,6,38,68,76,0,Matches
67,Chris Brunt,nir NIR,"MF,DF",West Brom,32,1984,21.3,41,24,19,21,1,11,31,35.5,20,28,4,24,22,63,45,1,Matches
68,Oliver Burke,sct SCO,"FW,MF",West Brom,20,1997,4.1,6,4,3,2,1,4,12,33.3,8,3,0,3,7,13,3,0,Matches
69,Jack Butland,eng ENG,GK,Stoke City,24,1993,35.0,1,1,1,0,0,1,1,100.0,0,1,0,1,1,2,26,1,Matches
70,Sam Byram,eng ENG,"DF,MF",West Ham,23,1993,2.8,9,5,6,3,0,4,9,44.4,5,6,2,4,9,18,16,0,Matches
71,Willy Caballero,ar ARG,GK,Chelsea,35,1981,3.0,0,0,0,0,0,0,0,,0,0,0,0,0,0,3,0,Matches
72,Yohan Cabaye,fr FRA,MF,Crystal Palace,31,1986,26.4,70,44,39,28,3,24,97,24.7,73,47,4,43,79,149,29,4,Matches
73,Gary Cahill,eng ENG,DF,Chelsea,31,1985,23.2,29,21,15,9,5,10,21,47.6,11,21,14,7,27,56,127,1,Matches
74,Dominic Calvert-Lewin,eng ENG,FW,Everton,20,1997,20.9,15,8,5,3,7,2,15,13.3,13,13,1,12,10,25,23,1,Matches
75,Geoff Cameron,us USA,"DF,MF",Stoke City,32,1985,16.9,34,21,20,12,2,11,27,40.7,16,28,8,20,36,70,68,0,Matches
76,Tyrese Campbell,eng ENG,FW,Stoke City,17,1999,0.9,2,1,0,2,0,1,1,100.0,0,1,1,0,1,3,0,0,Matches
77,Emre Can,de GER,MF,Liverpool,23,1994,23.2,67,54,32,29,6,18,43,41.9,25,32,4,28,28,95,37,1,Matches
78,Étienne Capoue,fr FRA,MF,Watford,29,1988,17.1,43,26,15,25,3,19,47,40.4,28,21,1,20,43,86,38,0,Matches
79,Michael Carrick,eng ENG,MF,Manchester Utd,36,1981,1.2,1,1,0,1,0,0,1,0.0,1,2,0,2,1,2,3,0,Matches
80,André Carrillo,pe PER,"FW,MF",Watford,26,1991,17.1,31,24,16,12,3,8,33,24.2,25,7,0,7,15,46,16,0,Matches
81,Guido Carrillo,ar ARG,FW,Southampton,26,1991,5.0,5,1,0,3,2,0,1,0.0,1,4,0,4,0,5,5,0,Matches
82,Andy Carroll,eng ENG,FW,West Ham,28,1989,8.3,3,3,2,0,1,0,1,0.0,1,3,2,1,2,5,15,0,Matches
83,Tom Carroll,eng ENG,MF,Swansea City,25,1992,28.6,53,33,22,23,8,14,53,26.4,39,37,8,29,29,82,18,1,Matches
84,Craig Cathcart,nir NIR,DF,Watford,28,1989,5.8,8,5,5,3,0,4,5,80.0,1,8,6,2,3,11,38,0,Matches
85,Petr Čech,cz CZE,GK,Arsenal,35,1982,33.8,1,1,1,0,0,1,1,100.0,0,0,0,0,0,1,23,7,Matches
86,Nacer Chadli,be BEL,"FW,MF",West Brom,27,1989,2.9,1,0,1,0,0,1,4,25.0,3,0,0,0,0,1,4,0,Matches
87,Nathaniel Chalobah,eng ENG,MF,Watford,22,1994,5.0,9,6,2,6,1,2,5,40.0,3,6,5,1,6,15,6,0,Matches
88,Calum Chambers,eng ENG,DF,Arsenal,22,1995,9.6,17,10,10,6,1,5,14,35.7,9,14,11,3,18,35,47,0,Matches
89,Ben Chilwell,eng ENG,DF,Leicester City,20,1996,20.6,36,26,21,10,5,15,32,46.9,17,31,4,27,28,64,71,3,Matches
90,Hamza Choudhury,eng ENG,"MF,DF",Leicester City,19,1997,4.2,9,5,6,3,0,2,10,20.0,8,12,1,11,8,17,4,0,Matches
91,Andreas Christensen,dk DEN,DF,Chelsea,21,1996,23.2,26,13,23,3,0,10,15,66.7,5,25,17,8,39,65,109,5,Matches
92,Lee Chung-yong,kr KOR,"FW,MF",Crystal Palace,29,1988,1.5,2,0,0,1,1,0,0,,0,3,0,3,2,4,0,1,Matches
93,Ciaran Clark,ie IRL,DF,Newcastle Utd,27,1989,19.4,25,17,17,8,0,11,21,52.4,10,15,10,5,17,42,144,1,Matches
94,Tom Cleverley,eng ENG,MF,Watford,27,1989,21.1,48,26,25,16,7,21,52,40.4,31,11,1,10,25,73,21,0,Matches
95,Sam Clucas,eng ENG,MF,Swansea City,26,1990,22.7,34,19,21,11,2,10,29,34.5,19,31,7,24,29,63,34,1,Matches
96,Nathaniel Clyne,eng ENG,"DF,FW",Liverpool,26,1991,1.9,3,1,2,1,0,0,1,0.0,1,2,1,1,0,3,3,0,Matches
97,Séamus Coleman,ie IRL,DF,Everton,28,1988,11.5,14,14,9,3,2,6,11,54.5,5,16,12,4,10,24,29,2,Matches
98,James Collins,wls WAL,DF,West Ham,33,1983,11.7,15,9,11,4,0,8,11,72.7,3,13,10,3,16,31,120,1,Matches
99,Lewis Cook,eng ENG,MF,Bournemouth,20,1997,24.9,67,35,37,30,0,26,69,37.7,43,33,12,21,35,102,25,2,Matches
100,Steve Cook,eng ENG,DF,Bournemouth,26,1991,30.7,37,19,28,7,2,19,29,65.5,10,63,45,18,54,91,232,4,Matches
101,Francis Coquelin,fr FRA,"MF,DF",Arsenal,26,1991,1.9,5,4,2,3,0,1,3,33.3,2,1,0,1,3,8,2,0,Matches
102,Jack Cork,eng ENG,MF,Burnley,28,1989,38.0,60,44,25,27,8,20,62,32.3,42,36,15,21,41,101,86,1,Matches
103,Thibaut Courtois,be BEL,GK,Chelsea,25,1992,35.0,0,0,0,0,0,0,0,,0,0,0,0,0,0,8,1,Matches
104,Philippe Coutinho,br BRA,"MF,FW",Liverpool,25,1992,12.3,17,14,4,10,3,3,21,14.3,18,10,0,10,10,27,5,1,Matches
105,Martin Cranie,eng ENG,DF,Huddersfield,30,1986,2.0,3,2,2,1,0,0,1,0.0,1,3,3,0,1,4,10,0,Matches
106,Aaron Cresswell,eng ENG,DF,West Ham,27,1989,34.1,34,21,12,20,2,19,30,63.3,11,42,17,25,44,78,117,1,Matches
107,Peter Crouch,eng ENG,FW,Stoke City,36,1981,17.4,2,0,0,1,1,0,12,0.0,12,7,4,3,1,3,31,0,Matches
108,Josh Cullen,ie IRL,MF,West Ham,21,1996,0.1,0,0,0,0,0,0,1,0.0,1,1,1,0,2,2,0,0,Matches
109,Charlie Daniels,eng ENG,"DF,MF",Bournemouth,30,1986,33.4,48,34,32,12,4,22,41,53.7,19,34,7,27,31,79,114,0,Matches
110,Danilo,br BRA,DF,Manchester City,26,1991,15.0,43,29,25,12,6,19,35,54.3,16,15,6,9,19,62,33,0,Matches
111,Scott Dann,eng ENG,DF,Crystal Palace,30,1987,15.9,10,5,8,2,0,7,17,41.2,10,17,14,3,23,33,98,1,Matches
112,Karl Darlow,wls WAL,GK,Newcastle Utd,26,1990,10.0,0,0,0,0,0,0,0,,0,0,0,0,0,0,3,4,Matches
113,Matteo Darmian,it ITA,DF,Manchester Utd,27,1989,4.9,16,14,7,7,2,6,19,31.6,13,5,3,2,7,23,23,0,Matches
114,Ben Davies,wls WAL,DF,Tottenham,24,1993,25.8,47,33,13,21,13,25,48,52.1,23,24,5,19,28,75,70,1,Matches
115,Tom Davies,eng ENG,MF,Everton,19,1998,21.1,30,20,14,11,5,12,54,22.2,42,19,5,14,24,54,21,0,Matches
116,Steven Davis,nir NIR,MF,Southampton,32,1985,16.9,30,21,10,17,3,11,30,36.7,19,22,6,16,15,45,24,1,Matches
117,Craig Dawson,eng ENG,DF,West Brom,27,1990,27.9,38,28,25,7,6,13,36,36.1,23,39,26,13,52,90,140,0,Matches
118,Kevin De Bruyne,be BEL,MF,Manchester City,26,1991,34.1,62,43,23,25,14,23,80,28.8,57,45,2,43,25,87,14,2,Matches
119,Troy Deeney,eng ENG,FW,Watford,29,1988,20.5,15,11,3,8,4,3,11,27.3,8,14,1,13,5,20,20,0,Matches
120,Jermain Defoe,eng ENG,FW,Bournemouth,34,1982,12.1,12,9,2,6,4,2,10,20.0,8,10,0,10,4,16,1,0,Matches
121,Steven Defour,be BEL,MF,Burnley,29,1988,22.2,33,22,12,18,3,10,46,21.7,36,35,7,28,46,79,25,0,Matches
122,Damien Delaney,ie IRL,DF,Crystal Palace,36,1981,1.1,2,1,2,0,0,1,1,100.0,0,5,4,1,3,5,7,0,Matches
123,Fabian Delph,eng ENG,DF,Manchester City,27,1989,19.3,46,34,21,16,9,18,37,48.6,19,16,0,16,30,76,42,2,Matches
124,Mousa Dembélé,be BEL,MF,Tottenham,30,1987,20.9,36,24,19,11,6,9,37,24.3,28,20,0,20,33,69,15,0,Matches
125,Laurent Depoitre,be BEL,FW,Huddersfield,28,1988,20.2,14,8,4,8,2,3,21,14.3,18,15,3,12,11,25,36,0,Matches
126,Mike van der Hoorn,nl NED,DF,Swansea City,24,1992,21.6,32,22,23,8,1,16,24,66.7,8,24,14,10,39,71,127,0,Matches
127,Gerard Deulofeu,es ESP,"FW,MF",Watford,23,1994,4.8,5,3,2,2,1,2,11,18.2,9,0,0,0,4,9,3,1,Matches
128,Fousseni Diabaté,ml MLI,"MF,FW",Leicester City,21,1995,6.5,9,6,5,3,1,1,4,25.0,3,6,0,6,8,17,8,0,Matches
129,Mohamed Diamé,sn SEN,MF,Newcastle Utd,30,1987,22.7,89,64,33,48,8,16,62,25.8,46,44,7,37,48,137,30,2,Matches
130,Brahim Díaz,ma MAR,"FW,DF",Manchester City,17,1999,0.6,1,0,1,0,0,0,0,,0,3,0,3,1,2,0,0,Matches
131,Eric Dier,eng ENG,"MF,DF",Tottenham,23,1994,31.4,61,43,15,39,7,17,42,40.5,25,32,11,21,48,109,93,7,Matches
132,Abdoulaye Doucouré,ml MLI,MF,Watford,24,1993,36.9,79,52,28,42,9,27,79,34.2,52,43,10,33,54,133,61,0,Matches
133,Aleksandar Dragović,at AUT,DF,Leicester City,26,1991,8.5,13,10,13,0,0,7,13,53.8,6,16,8,8,16,29,46,0,Matches
134,Danny Drinkwater,eng ENG,MF,Chelsea,27,1990,5.9,15,10,6,8,1,3,17,17.6,14,10,2,8,8,23,7,0,Matches
135,Martin Dúbravka,sk SVK,GK,Newcastle Utd,28,1989,12.0,0,0,0,0,0,0,0,,0,0,0,0,0,0,3,2,Matches
136,Shane Duffy,ie IRL,DF,Brighton,25,1992,36.6,31,19,22,9,0,7,20,35.0,13,66,59,7,50,81,332,5,Matches
137,Paul Dummett,wls WAL,DF,Newcastle Utd,25,1991,17.8,28,19,21,7,0,13,27,48.1,14,27,10,17,23,51,107,1,Matches
138,Lewis Dunk,eng ENG,DF,Brighton,25,1991,38.0,67,33,49,18,0,25,48,52.1,23,73,58,15,71,138,230,2,Matches
139,Nathan Dyer,eng ENG,"MF,FW",Swansea City,29,1987,14.5,22,16,8,9,5,6,24,25.0,18,13,0,13,11,33,3,0,Matches
140,Ederson,br BRA,GK,Manchester City,23,1993,35.5,1,1,1,0,0,0,0,,0,1,0,1,0,1,15,6,Matches
141,Tom Edwards,eng ENG,"DF,MF",Stoke City,18,1999,5.3,15,9,10,5,0,8,8,100.0,0,5,2,3,5,20,20,0,Matches
142,Rob Elliot,ie IRL,GK,Newcastle Utd,31,1986,16.0,0,0,0,0,0,0,1,0.0,1,0,0,0,0,0,8,0,Matches
143,Mohamed Elneny,eg EGY,MF,Arsenal,25,1992,9.6,12,6,6,3,3,6,10,60.0,4,11,0,11,10,22,12,2,Matches
144,Christian Eriksen,dk DEN,"MF,FW",Tottenham,25,1992,35.8,51,29,16,30,5,17,59,28.8,42,38,1,37,31,82,21,0,Matches
145,Jonny Evans,nir NIR,DF,West Brom,29,1988,25.2,29,22,19,8,2,14,33,42.4,19,22,13,9,48,77,131,1,Matches
146,Patrice Evra,fr FRA,"DF,MF",West Ham,36,1981,2.5,6,4,5,1,0,6,8,75.0,2,4,1,3,7,13,6,0,Matches
147,Łukasz Fabiański,pl POL,GK,Swansea City,32,1985,38.0,0,0,0,0,0,0,0,,0,0,0,0,0,0,10,2,Matches
148,Cesc Fàbregas,es ESP,MF,Chelsea,30,1987,25.6,68,49,30,29,9,18,69,26.1,51,25,4,21,22,90,26,2,Matches
149,Marouane Fellaini,be BEL,MF,Manchester Utd,29,1987,7.6,15,8,6,8,1,2,11,18.2,9,12,3,9,14,29,19,1,Matches
150,Kiko Femenía,es ESP,"DF,FW",Watford,26,1991,19.0,36,28,22,11,3,14,27,51.9,13,15,2,13,34,70,31,1,Matches
151,Leroy Fer,nl NED,MF,Swansea City,27,1990,15.5,44,32,18,21,5,13,30,43.3,17,18,4,14,12,56,24,3,Matches
152,Edimilson Fernandes,ch SUI,"MF,DF",West Ham,21,1996,9.4,17,9,10,7,0,9,21,42.9,12,13,1,12,16,33,8,0,Matches
153,Federico Fernández,ar ARG,DF,Swansea City,28,1989,29.7,40,29,30,6,4,20,30,66.7,10,35,27,8,38,78,201,1,Matches
154,Fernandinho,br BRA,MF,Manchester City,32,1985,32.0,62,35,22,28,12,24,65,36.9,41,38,6,32,47,109,68,2,Matches
155,Sam Field,eng ENG,MF,West Brom,19,1998,6.0,14,11,8,4,2,3,10,30.0,7,6,1,5,11,25,8,0,Matches
156,Roberto Firmino,br BRA,FW,Liverpool,25,1991,30.7,65,50,9,36,20,8,58,13.8,50,40,2,38,18,83,10,0,Matches
157,Darren Fletcher,sct SCO,MF,Stoke City,33,1984,24.7,47,26,23,20,4,15,55,27.3,40,13,3,10,26,73,33,3,Matches
158,Phil Foden,eng ENG,"MF,FW",Manchester City,17,2000,0.5,1,1,0,1,0,0,1,0.0,1,0,0,0,0,1,1,0,Matches
159,José Fonte,pt POR,DF,West Ham,33,1983,7.6,11,6,5,6,0,2,6,33.3,4,12,9,3,14,25,37,1,Matches
160,Fraser Forster,eng ENG,GK,Southampton,29,1988,20.0,0,0,0,0,0,0,0,,0,0,0,0,0,0,7,4,Matches
161,Ben Foster,eng ENG,GK,West Brom,34,1983,37.0,1,0,1,0,0,0,7,0.0,7,0,0,0,1,2,12,1,Matches
162,Timothy Fosu-Mensah,nl NED,DF,Crystal Palace,19,1998,17.7,42,33,33,8,1,21,34,61.8,13,17,9,8,31,73,74,1,Matches
163,Simon Francis,eng ENG,DF,Bournemouth,32,1985,30.1,49,34,26,16,7,24,43,55.8,19,29,18,11,49,98,194,4,Matches
164,Ryan Fraser,sct SCO,"MF,DF",Bournemouth,23,1994,22.3,11,8,7,2,2,7,20,35.0,13,20,4,16,17,28,34,0,Matches
165,Christian Fuchs,at AUT,DF,Leicester City,31,1986,21.3,41,27,25,12,4,14,40,35.0,26,23,3,20,58,99,86,0,Matches
166,Jay Fulton,sct SCO,MF,Swansea City,23,1994,0.2,0,0,0,0,0,0,0,,0,0,0,0,0,0,1,0,Matches
167,Ramiro Funes Mori,ar ARG,DF,Everton,26,1991,1.3,0,0,0,0,0,0,0,,0,1,1,0,3,3,14,0,Matches
168,Manolo Gabbiadini,it ITA,FW,Southampton,25,1991,12.0,3,2,0,2,1,1,15,6.7,14,3,0,3,4,7,6,0,Matches
169,Jesús Gámez,es ESP,DF,Newcastle Utd,32,1985,1.1,4,2,1,0,3,1,3,33.3,2,2,0,2,2,6,5,0,Matches
170,Idrissa Gana Gueye,sn SEN,MF,Everton,27,1989,30.6,117,93,65,41,11,35,86,40.7,51,59,9,50,62,179,48,1,Matches
171,Dwight Gayle,eng ENG,FW,Newcastle Utd,26,1990,21.8,12,10,2,8,2,1,21,4.8,20,16,2,14,6,18,17,0,Matches
172,Paulo Gazzaniga,ar ARG,GK,Tottenham,25,1992,1.0,0,0,0,0,0,0,1,0.0,1,0,0,0,0,0,0,0,Matches
173,David de Gea,es ESP,GK,Manchester Utd,26,1990,37.0,0,0,0,0,0,0,1,0.0,1,1,0,1,0,0,9,3,Matches
174,Kieran Gibbs,eng ENG,DF,West Brom,27,1989,31.4,41,24,27,10,4,16,30,53.3,14,32,12,20,48,89,102,0,Matches
175,Olivier Giroud,fr FRA,FW,Arsenal,30,1986,4.3,5,4,1,2,2,1,5,20.0,4,1,0,1,1,6,4,0,Matches
176,Olivier Giroud,fr FRA,FW,Chelsea,30,1986,6.8,4,3,1,2,1,1,3,33.3,2,0,0,0,1,5,5,0,Matches
177,Connor Goldson,eng ENG,DF,Brighton,24,1992,2.2,2,2,1,1,0,1,4,25.0,3,3,3,0,1,3,9,0,Matches
178,Heurelho Gomes,br BRA,GK,Watford,36,1981,23.6,0,0,0,0,0,0,1,0.0,1,1,0,1,2,2,15,3,Matches
179,Joe Gomez,eng ENG,DF,Liverpool,20,1997,21.1,58,45,32,23,3,21,40,52.5,19,19,8,11,34,92,57,1,Matches
180,Dan Gosling,eng ENG,MF,Bournemouth,27,1990,21.6,50,25,19,26,5,19,68,27.9,49,36,8,28,25,75,35,0,Matches
181,Lee Grant,eng ENG,GK,Stoke City,34,1983,3.0,1,1,1,0,0,1,1,100.0,0,0,0,0,0,1,0,0,Matches
182,Andre Gray,jm JAM,FW,Watford,26,1991,16.6,2,1,0,1,1,0,3,0.0,3,11,0,11,4,6,3,0,Matches
183,Demarai Gray,jm JAM,"MF,FW",Leicester City,21,1996,18.9,17,15,6,9,2,4,23,17.4,19,27,0,27,11,28,14,1,Matches
184,Pascal Groß,de GER,"FW,MF",Brighton,26,1991,32.5,36,24,18,16,2,10,67,14.9,57,31,5,26,14,50,20,0,Matches
185,Marko Grujić,rs SRB,"MF,DF",Liverpool,21,1996,0.2,2,2,0,1,1,2,2,100.0,0,0,0,0,0,2,0,0,Matches
186,İlkay Gündoğan,de GER,MF,Manchester City,26,1990,16.9,27,15,8,14,5,9,37,24.3,28,14,1,13,16,43,12,0,Matches
187,Florent Hadergjonaj,xk KVX,"DF,MF",Huddersfield,23,1994,18.6,21,16,7,10,4,12,30,40.0,18,22,10,12,17,38,45,0,Matches
188,Massadio Haïdara,ml MLI,FW,Newcastle Utd,24,1992,0.0,0,0,0,0,0,0,0,,0,0,0,0,0,0,0,0,Matches
189,Ben Hamer,eng ENG,GK,Leicester City,29,1987,3.1,0,0,0,0,0,0,1,0.0,1,0,0,0,0,0,3,1,Matches
190,Rekeem Harper,eng ENG,MF,West Brom,17,2000,0.2,1,1,0,1,0,0,0,,0,0,0,0,0,1,0,0,Matches
191,Joe Hart,eng ENG,GK,West Ham,30,1987,19.0,1,1,1,0,0,1,2,50.0,1,1,0,1,0,1,2,4,Matches
192,Isaac Hayden,eng ENG,MF,Newcastle Utd,22,1995,15.3,40,23,23,16,1,12,34,35.3,22,21,6,15,23,63,43,0,Matches
193,Eden Hazard,be BEL,"FW,MF",Chelsea,26,1991,26.9,6,3,2,3,1,3,21,14.3,18,11,0,11,3,9,0,0,Matches
194,Tom Heaton,eng ENG,GK,Burnley,31,1986,3.4,0,0,0,0,0,0,0,,0,0,0,0,0,0,0,0,Matches
195,Michael Hefele,de GER,DF,Huddersfield,26,1990,0.4,0,0,0,0,0,0,0,,0,0,0,0,1,1,5,0,Matches
196,Ahmed Hegazi,eg EGY,DF,West Brom,26,1991,37.6,58,38,46,12,0,26,50,52.0,24,55,37,18,60,118,278,2,Matches
197,Tomer Hemed,il ISR,FW,Brighton,30,1987,9.4,7,5,3,4,0,2,10,20.0,8,10,1,9,2,9,12,0,Matches
198,Jordan Henderson,eng ENG,MF,Liverpool,27,1990,24.1,51,33,13,32,6,18,52,34.6,34,33,2,31,31,82,27,0,Matches
199,Jeff Hendrick,ie IRL,"FW,MF",Burnley,25,1992,25.9,16,10,4,10,2,3,17,17.6,14,11,2,9,8,24,21,1,Matches
200,Wayne Hennessey,wls WAL,GK,Crystal Palace,30,1987,27.0,0,0,0,0,0,0,0,,0,1,0,1,2,2,5,1,Matches
201,Javier Hernández,mx MEX,FW,West Ham,29,1988,17.2,11,7,2,7,2,3,14,21.4,11,6,1,5,6,17,1,0,Matches
202,Ander Herrera,es ESP,MF,Manchester Utd,27,1989,14.1,56,29,32,20,4,20,69,29.0,49,33,6,27,34,90,22,2,Matches
203,Son Heung-min,kr KOR,FW,Tottenham,25,1992,25.7,17,10,2,12,3,2,28,7.1,26,18,0,18,10,27,12,0,Matches
204,Wesley Hoedt,nl NED,DF,Southampton,23,1994,28.0,60,51,48,12,0,36,61,59.0,25,32,17,15,40,100,177,2,Matches
205,Jonathan Hogg,eng ENG,MF,Huddersfield,28,1988,26.6,93,64,29,59,5,26,89,29.2,63,51,12,39,69,162,48,0,Matches
206,Rob Holding,eng ENG,DF,Arsenal,21,1995,9.1,19,14,13,5,1,4,12,33.3,8,16,10,6,21,40,40,2,Matches
207,José Holebas,gr GRE,DF,Watford,33,1984,26.5,51,31,34,14,3,18,44,40.9,26,24,8,16,29,80,95,2,Matches
208,Mason Holgate,eng ENG,DF,Everton,20,1996,13.2,23,16,15,7,1,10,21,47.6,11,12,9,3,23,46,86,2,Matches
209,Callum Hudson-Odoi,eng ENG,"FW,DF",Chelsea,16,2000,0.3,0,0,0,0,0,0,0,,0,0,0,0,0,0,0,0,Matches
210,Will Hughes,eng ENG,MF,Watford,22,1995,11.0,34,18,7,18,9,9,19,47.4,10,16,1,15,15,49,6,0,Matches
211,Jordan Hugill,eng ENG,FW,West Ham,25,1992,0.3,0,0,0,0,0,0,1,0.0,1,0,0,0,0,0,0,0,Matches
212,Uwe Hünemeier,de GER,DF,Brighton,31,1986,0.2,0,0,0,0,0,0,0,,0,0,0,0,0,0,4,0,Matches
213,Emerson Hyndman,us USA,MF,Bournemouth,21,1996,0.6,0,0,0,0,0,0,1,0.0,1,2,0,2,1,1,1,0,Matches
214,Pierre Højbjerg,dk DEN,MF,Southampton,21,1995,18.6,45,29,24,18,3,13,56,23.2,43,30,3,27,37,82,26,1,Matches
215,Jordon Ibe,eng ENG,"MF,FW",Bournemouth,21,1995,22.2,14,12,7,5,2,6,22,27.3,16,5,0,5,10,24,11,0,Matches
216,Vicente Iborra,es ESP,MF,Leicester City,29,1988,15.7,23,18,13,10,0,9,36,25.0,27,25,11,14,19,42,49,1,Matches
217,Zlatan Ibrahimović,se SWE,"MF,FW",Manchester Utd,35,1981,1.2,2,1,1,0,1,0,1,0.0,1,0,0,0,0,2,1,0,Matches
218,Kelechi Iheanacho,ng NGA,"FW,MF",Leicester City,20,1996,9.2,9,6,3,5,1,3,20,15.0,17,10,2,8,3,12,4,0,Matches
219,Tom Ince,eng ENG,"MF,FW",Huddersfield,25,1992,27.2,35,27,14,16,5,10,29,34.5,19,20,0,20,12,47,12,0,Matches
220,Danny Ings,eng ENG,FW,Liverpool,25,1992,3.0,5,3,1,3,1,0,0,,0,4,0,4,2,7,1,0,Matches
221,Stephen Ireland,ie IRL,"MF,FW",Stoke City,30,1986,1.5,3,1,2,1,0,1,5,20.0,4,4,2,2,1,4,1,0,Matches
222,Alex Iwobi,ng NGA,"MF,FW",Arsenal,21,1996,20.3,19,15,8,8,3,5,18,27.8,13,19,1,18,7,26,10,1,Matches
223,José Izquierdo,co COL,"MF,FW",Brighton,25,1992,22.0,23,15,12,9,2,7,19,36.8,12,6,0,6,16,39,34,0,Matches
224,Phil Jagielka,eng ENG,DF,Everton,34,1982,22.9,33,23,24,9,0,8,21,38.1,13,30,20,10,39,72,179,1,Matches
225,Eldin Jakupović,ch SUI,GK,Leicester City,32,1984,2.0,0,0,0,0,0,0,0,,0,0,0,0,0,0,4,0,Matches
226,Matty James,eng ENG,MF,Leicester City,26,1991,11.0,19,10,7,11,1,2,10,20.0,8,14,2,12,17,36,25,0,Matches
227,Daryl Janmaat,nl NED,DF,Watford,28,1989,20.2,46,31,29,10,7,22,52,42.3,30,16,5,11,33,79,61,0,Matches
228,Vincent Janssen,nl NED,DF,Tottenham,23,1994,0.0,0,0,0,0,0,0,0,,0,0,0,0,0,0,0,0,Matches
229,Jesé,es ESP,"FW,MF",Stoke City,24,1993,6.8,10,7,3,5,2,3,13,23.1,10,5,0,5,0,10,3,0,Matches
230,Gabriel Jesus,br BRA,FW,Manchester City,20,1997,18.5,23,15,6,10,7,3,22,13.6,19,16,0,16,8,31,6,0,Matches
231,Glen Johnson,eng ENG,DF,Stoke City,32,1984,6.1,7,5,5,2,0,3,12,25.0,9,7,2,5,10,17,23,0,Matches
232,Phil Jones,eng ENG,DF,Manchester Utd,25,1992,21.9,25,18,20,5,0,9,20,45.0,11,25,17,8,41,66,133,2,Matches
233,Joselu,es ESP,FW,Newcastle Utd,27,1990,19.0,22,17,10,11,1,7,34,20.6,27,25,2,23,11,33,39,0,Matches
234,Mathias Jørgensen,dk DEN,DF,Huddersfield,27,1990,38.0,55,36,40,13,2,19,45,42.2,26,49,20,29,76,131,249,5,Matches
235,Christian Kabasele,be BEL,DF,Watford,26,1991,25.9,42,25,28,14,0,21,36,58.3,15,37,23,14,34,76,185,0,Matches
236,Younès Kaboul,fr FRA,DF,Watford,31,1986,1.7,3,2,0,3,0,0,0,,0,4,2,2,2,5,15,0,Matches
237,Elias Kachunga,cd COD,"FW,MF",Huddersfield,25,1992,14.8,30,26,13,12,5,8,19,42.1,11,14,1,13,2,32,9,0,Matches
238,Sullay Kaikai,sl SLE,MF,Crystal Palace,21,1995,0.2,1,0,0,1,0,0,0,,0,1,0,1,0,1,1,0,Matches
239,Harry Kane,eng ENG,FW,Tottenham,24,1993,34.2,17,12,2,8,7,4,15,26.7,11,15,4,11,5,22,19,0,Matches
240,N'Golo Kanté,fr FRA,MF,Chelsea,26,1991,33.3,113,77,55,52,6,33,92,35.9,59,40,4,36,85,198,29,3,Matches
241,Loris Karius,de GER,GK,Liverpool,24,1993,19.0,0,0,0,0,0,0,0,,0,0,0,0,1,1,4,0,Matches
242,Orestis Karnezis,gr GRE,GK,Watford,32,1985,14.4,0,0,0,0,0,0,2,0.0,2,0,0,0,1,1,3,3,Matches
243,Beram Kayal,il ISR,MF,Brighton,29,1988,8.3,18,11,10,7,1,6,26,23.1,20,11,4,7,12,30,9,0,Matches
244,Michael Keane,eng ENG,DF,Everton,24,1993,28.4,33,25,26,5,2,19,43,44.2,24,39,28,11,53,86,214,0,Matches
245,Martin Kelly,eng ENG,DF,Crystal Palace,27,1990,13.3,19,13,15,4,0,14,26,53.8,12,16,11,5,9,28,67,3,Matches
246,Kenedy,br BRA,"MF,DF",Newcastle Utd,21,1996,11.4,31,17,16,13,2,12,35,34.3,23,12,1,11,14,45,11,0,Matches
247,Jonjoe Kenny,eng ENG,DF,Everton,20,1997,17.7,41,33,28,10,3,20,32,62.5,12,17,7,10,28,69,95,0,Matches
248,Andy King,wls WAL,MF,Leicester City,28,1988,6.0,8,5,0,5,3,0,3,0.0,3,4,2,2,5,13,13,0,Matches
249,Andy King,wls WAL,MF,Swansea City,28,1988,7.9,18,11,10,8,0,5,14,35.7,9,7,0,7,6,24,14,1,Matches
250,Joshua King,no NOR,"FW,MF",Bournemouth,25,1992,27.3,36,26,11,17,8,4,27,14.8,23,23,3,20,4,40,14,1,Matches
251,Davy Klaassen,nl NED,"MF,FW",Everton,24,1993,2.8,3,1,1,2,0,2,6,33.3,4,2,1,1,1,4,2,0,Matches
252,Ragnar Klavan,ee EST,DF,Liverpool,31,1985,16.1,14,10,6,7,1,6,12,50.0,6,11,5,6,15,29,85,1,Matches
253,Anthony Knockaert,fr FRA,"MF,FW",Brighton,25,1991,26.9,39,26,25,11,3,16,55,29.1,39,29,3,26,23,62,16,0,Matches
254,Sead Kolašinac,ba BIH,DF,Arsenal,24,1993,23.9,49,37,28,13,8,20,39,51.3,19,15,3,12,26,75,56,0,Matches
255,Vincent Kompany,be BEL,DF,Manchester City,31,1986,15.5,20,11,14,5,1,13,19,68.4,6,10,8,2,16,36,73,1,Matches
256,Terence Kongolo,nl NED,DF,Huddersfield,23,1994,11.7,33,20,19,13,1,14,22,63.6,8,12,6,6,32,65,71,0,Matches
257,Laurent Koscielny,fr FRA,DF,Arsenal,31,1985,24.7,43,21,27,12,4,19,33,57.6,14,28,15,13,54,97,138,3,Matches
258,Cheikhou Kouyaté,sn SEN,MF,West Ham,27,1989,31.1,71,49,43,26,2,23,62,37.1,39,31,11,20,32,103,56,1,Matches
259,Bojan Krkić,es ESP,MF,Stoke City,26,1990,0.8,0,0,0,0,0,0,1,0.0,1,1,0,1,0,0,0,0,Matches
260,Grzegorz Krychowiak,pl POL,MF,West Brom,27,1990,18.2,39,24,18,17,4,12,49,24.5,37,23,5,18,45,84,23,0,Matches
261,Rajiv van La Parra,nl NED,"FW,MF",Huddersfield,26,1991,23.7,41,29,18,15,8,12,41,29.3,29,27,1,26,21,62,8,1,Matches
262,Alexandre Lacazette,fr FRA,FW,Arsenal,26,1991,24.5,24,17,6,11,7,4,27,14.8,23,19,3,16,7,31,5,0,Matches
263,Freddie Ladapo,eng ENG,FW,Crystal Palace,24,1993,0.2,0,0,0,0,0,0,0,,0,0,0,0,0,0,0,0,Matches
264,Adam Lallana,eng ENG,"MF,FW",Liverpool,29,1988,3.4,3,1,3,0,0,2,10,20.0,8,3,0,3,1,4,1,0,Matches
265,Érik Lamela,ar ARG,"FW,MF",Tottenham,25,1992,9.4,23,13,9,7,7,3,20,15.0,17,11,1,10,7,30,5,0,Matches
266,Manuel Lanzini,ar ARG,"MF,FW",West Ham,24,1993,22.7,20,11,6,11,3,2,34,5.9,32,7,1,6,30,50,5,2,Matches
267,Aymeric Laporte,es ESP,DF,Manchester City,23,1994,9.0,8,7,6,2,0,3,8,37.5,5,2,1,1,11,19,27,0,Matches
268,Jamaal Lascelles,eng ENG,DF,Newcastle Utd,23,1993,32.5,31,19,19,11,1,12,19,63.2,7,33,24,9,28,59,232,1,Matches
269,Florian Lejeune,fr FRA,DF,Newcastle Utd,26,1991,23.4,34,20,26,8,0,14,30,46.7,16,21,15,6,46,80,154,0,Matches
270,Mario Lemina,ga GAB,MF,Southampton,23,1993,19.1,55,40,21,29,5,12,30,40.0,18,18,6,12,36,91,36,4,Matches
271,Aaron Lennon,eng ENG,MF,Burnley,30,1987,12.4,20,14,5,14,1,2,20,10.0,18,20,5,15,8,28,18,0,Matches
272,Aaron Lennon,eng ENG,"FW,MF",Everton,30,1987,8.8,17,10,10,5,2,5,21,23.8,16,13,1,12,11,28,9,0,Matches
273,Victor Lindelöf,se SWE,DF,Manchester Utd,23,1994,14.3,17,11,10,6,1,9,14,64.3,5,15,11,4,13,30,67,1,Matches
274,Jesse Lingard,eng ENG,"MF,FW",Manchester Utd,24,1992,20.2,30,21,10,13,7,5,27,18.5,22,18,3,15,9,39,13,0,Matches
275,Jake Livermore,eng ENG,MF,West Brom,27,1989,29.7,72,41,27,35,10,24,64,37.5,40,44,9,35,26,98,36,2,Matches
276,Fernando Llorente,es ESP,"FW,MF",Tottenham,32,1985,2.6,6,3,1,2,3,1,2,50.0,1,0,0,0,0,6,6,0,Matches
277,Hugo Lloris,fr FRA,GK,Tottenham,30,1986,36.0,1,1,1,0,0,1,4,25.0,3,0,0,0,2,3,34,8,Matches
278,Jürgen Locadia,cw CUW,"FW,MF",Brighton,23,1993,2.5,1,0,0,1,0,0,1,0.0,1,0,0,0,1,2,1,1,Matches
279,Ruben Loftus-Cheek,eng ENG,MF,Crystal Palace,21,1996,20.8,21,15,7,13,1,7,30,23.3,23,19,2,17,22,43,31,0,Matches
280,Joe Lolley,eng ENG,"FW,MF",Huddersfield,24,1992,2.5,2,0,1,1,0,0,2,0.0,2,0,0,0,3,5,2,1,Matches
281,Kevin Long,ie IRL,DF,Burnley,26,1990,16.0,32,23,28,4,0,16,26,61.5,10,25,14,11,19,51,129,1,Matches
282,Shane Long,ie IRL,FW,Southampton,30,1987,17.6,25,20,1,19,5,10,30,33.3,20,14,2,12,12,37,29,0,Matches
283,Ademola Lookman,ng NGA,"FW,MF",Everton,19,1997,1.8,1,1,0,1,0,0,2,0.0,2,2,0,2,1,2,3,0,Matches
284,Jonas Lössl,dk DEN,GK,Huddersfield,28,1989,38.0,1,0,1,0,0,1,5,20.0,4,0,0,0,4,5,13,6,Matches
285,Dejan Lovren,hr CRO,DF,Liverpool,28,1989,23.6,26,17,14,11,1,12,22,54.5,10,26,15,11,38,64,146,2,Matches
286,Chris Löwe,de GER,DF,Huddersfield,28,1989,17.6,43,29,26,15,2,20,44,45.5,24,21,8,13,34,77,65,3,Matches
287,Matthew Lowton,eng ENG,DF,Burnley,28,1989,25.5,55,34,26,27,2,28,60,46.7,32,35,15,20,39,94,141,2,Matches
288,David Luiz,br BRA,"DF,MF",Chelsea,30,1987,9.3,18,11,13,4,1,11,21,52.4,10,9,5,4,24,42,45,2,Matches
289,Romelu Lukaku,be BEL,FW,Manchester Utd,24,1993,31.9,7,4,1,3,3,0,13,0.0,13,9,2,7,3,10,22,2,Matches
290,Dodi Lukebakio,be BEL,"MF,FW",Watford,19,1997,0.2,1,0,1,0,0,0,0,,0,0,0,0,0,1,0,0,Matches
291,Levi Lumeka,eng ENG,FW,Crystal Palace,18,1998,0.3,1,1,1,0,0,0,0,,0,0,0,0,1,2,0,0,Matches
292,Harry Maguire,eng ENG,DF,Leicester City,24,1993,38.0,63,46,47,15,1,26,43,60.5,17,35,28,7,48,111,181,1,Matches
293,Riyad Mahrez,dz ALG,"MF,FW",Leicester City,26,1991,32.8,39,27,16,17,6,10,63,15.9,53,32,1,31,18,57,15,0,Matches
294,Ainsley Maitland-Niles,eng ENG,"DF,MF",Arsenal,19,1997,10.2,25,17,12,7,6,14,31,45.2,17,15,1,14,12,37,35,2,Matches
295,Scott Malone,eng ENG,DF,Huddersfield,26,1991,12.4,39,29,27,10,2,17,24,70.8,7,12,2,10,26,65,43,2,Matches
296,Sadio Mané,sn SEN,FW,Liverpool,25,1992,24.3,28,20,8,11,9,3,23,13.0,20,20,0,20,9,37,8,0,Matches
297,Eliaquim Mangala,fr FRA,DF,Everton,26,1991,1.5,2,1,1,1,0,0,0,,0,0,0,0,1,3,4,1,Matches
298,Eliaquim Mangala,fr FRA,DF,Manchester City,26,1991,5.4,5,3,5,0,0,1,3,33.3,2,4,3,1,2,7,24,0,Matches
299,Javier Manquillo,es ESP,DF,Newcastle Utd,23,1994,19.5,36,22,25,8,3,15,30,50.0,15,25,6,19,18,54,65,0,Matches
300,Solly March,eng ENG,"MF,FW",Brighton,23,1994,20.6,54,41,34,14,6,22,54,40.7,32,27,3,24,13,67,49,0,Matches
301,Adrian Mariappa,jm JAM,DF,Watford,30,1986,24.6,45,26,33,12,0,14,34,41.2,20,25,16,9,45,90,133,4,Matches
302,João Mário,pt POR,MF,West Ham,24,1993,11.4,14,11,6,5,3,6,19,31.6,13,7,0,7,8,22,4,1,Matches
303,Anthony Martial,fr FRA,FW,Manchester Utd,21,1995,17.6,15,13,9,2,4,3,12,25.0,9,5,1,4,3,18,7,0,Matches
304,Cuco Martina,cw CUW,DF,Everton,27,1989,20.3,61,35,38,15,8,27,46,58.7,19,17,4,13,42,103,130,2,Matches
305,Bruno Martins Indi,nl NED,DF,Stoke City,25,1992,13.8,21,12,18,3,0,10,19,52.6,9,16,11,5,21,42,77,1,Matches
306,Arthur Masuaku,cd COD,DF,West Ham,23,1993,20.8,58,37,36,16,6,25,58,43.1,33,25,2,23,26,84,38,1,Matches
307,Juan Mata,es ESP,FW,Manchester Utd,29,1988,21.4,18,13,4,12,2,2,24,8.3,22,10,0,10,15,33,10,1,Matches
308,Nemanja Matić,rs SRB,MF,Manchester Utd,28,1988,34.6,70,42,32,34,4,23,71,32.4,48,50,13,37,64,134,62,2,Matches
309,Joël Matip,cm CMR,DF,Liverpool,25,1991,22.2,35,24,23,11,1,12,24,50.0,12,26,15,11,35,70,101,1,Matches
310,Konstantinos Mavropanos,gr GRE,DF,Arsenal,19,1997,2.2,1,1,1,0,0,1,2,50.0,1,4,3,1,6,7,11,1,Matches
311,Alfie Mawson,eng ENG,DF,Swansea City,23,1994,38.0,32,22,24,8,0,16,27,59.3,11,41,32,9,35,67,229,5,Matches
312,Eric Maxim Choupo-Moting,cm CMR,"FW,MF",Stoke City,28,1989,25.7,42,30,21,16,5,9,32,28.1,23,31,3,28,23,65,29,1,Matches
313,Chancel Mbemba,cd COD,DF,Newcastle Utd,22,1994,7.5,16,12,13,3,0,10,17,58.8,7,7,3,4,15,31,44,1,Matches
314,James McArthur,sct SCO,MF,Crystal Palace,29,1987,27.0,58,44,28,27,3,23,61,37.7,38,39,2,37,36,94,44,2,Matches
315,Gareth McAuley,nir NIR,DF,West Brom,37,1979,5.1,8,7,6,2,0,3,7,42.9,4,7,4,3,11,19,16,0,Matches
316,Oliver McBurnie,sct SCO,"FW,MF",Swansea City,21,1996,3.1,4,3,0,2,2,1,3,33.3,2,2,0,2,0,4,3,0,Matches
317,Alex McCarthy,eng ENG,GK,Southampton,27,1989,18.0,0,0,0,0,0,0,0,,0,0,0,0,1,1,8,0,Matches
318,James McCarthy,ie IRL,MF,Everton,26,1990,2.3,9,9,3,4,2,1,5,20.0,4,9,2,7,5,14,3,1,Matches
319,James McClean,ie IRL,"MF,FW",West Brom,28,1989,15.6,40,28,23,14,3,10,55,18.2,45,18,4,14,20,60,22,0,Matches
320,Sam McQueen,eng ENG,"DF,MF",Southampton,22,1995,1.6,4,4,4,0,0,2,4,50.0,2,2,1,1,3,7,3,0,Matches
321,Scott McTominay,sct SCO,MF,Manchester Utd,20,1996,7.0,11,9,4,5,2,5,13,38.5,8,3,0,3,13,24,9,0,Matches
322,Ben Mee,eng ENG,DF,Burnley,27,1989,29.0,33,20,22,11,0,16,29,55.2,13,51,42,9,33,66,217,1,Matches
323,Benjamin Mendy,fr FRA,"DF,FW",Manchester City,23,1994,4.0,5,4,2,0,3,5,7,71.4,2,5,0,5,8,13,9,0,Matches
324,Mikel Merino,es ESP,MF,Newcastle Utd,21,1996,15.0,56,40,21,32,3,17,56,30.4,39,36,8,28,34,90,25,0,Matches
325,Per Mertesacker,de GER,DF,Arsenal,32,1984,4.1,2,2,0,2,0,0,1,0.0,1,4,3,1,6,8,22,2,Matches
326,Roque Mesa,es ESP,MF,Swansea City,28,1989,8.4,20,13,8,8,4,10,37,27.0,27,6,0,6,13,33,8,1,Matches
327,Simon Mignolet,be BEL,GK,Liverpool,29,1988,19.0,2,1,2,0,0,1,3,33.3,2,0,0,0,0,2,5,3,Matches
328,Luka Milivojević,rs SRB,MF,Crystal Palace,26,1991,34.2,85,52,40,37,8,31,86,36.0,55,50,12,38,71,156,81,3,Matches
329,James Milner,eng ENG,MF,Liverpool,31,1986,19.7,58,45,18,32,8,15,39,38.5,24,33,5,28,21,79,23,0,Matches
330,Tyrone Mings,eng ENG,DF,Bournemouth,24,1993,2.2,1,1,1,0,0,0,0,,0,2,2,0,6,7,13,1,Matches
331,Kevin Mirallas,be BEL,"FW,MF",Everton,29,1987,1.5,4,3,1,2,1,0,1,0.0,1,0,0,0,0,4,3,0,Matches
332,Aleksandar Mitrović,rs SRB,FW,Newcastle Utd,22,1994,1.1,1,1,0,1,0,0,1,0.0,1,1,0,1,0,1,2,0,Matches
333,Henrikh Mkhitaryan,am ARM,"FW,MF",Arsenal,28,1989,8.8,18,13,9,7,2,5,21,23.8,16,16,2,14,8,26,7,0,Matches
334,Henrikh Mkhitaryan,am ARM,"MF,FW",Manchester Utd,28,1989,10.2,15,11,4,7,4,5,25,20.0,20,8,0,8,7,22,3,0,Matches
335,Nacho Monreal,es ESP,DF,Arsenal,31,1986,24.9,54,32,19,29,6,21,48,43.8,27,26,7,19,56,110,83,2,Matches
336,Aaron Mooy,au AUS,MF,Huddersfield,26,1990,34.1,102,60,39,51,12,23,55,41.8,32,39,5,34,38,140,52,0,Matches
337,Álvaro Morata,es ESP,FW,Chelsea,24,1992,22.9,13,8,0,7,6,1,21,4.8,20,17,4,13,6,19,20,0,Matches
338,Alberto Moreno,es ESP,DF,Liverpool,25,1992,14.1,35,26,21,12,2,13,29,44.8,16,19,2,17,12,47,44,0,Matches
339,Wes Morgan,jm JAM,DF,Leicester City,33,1984,31.3,35,25,26,8,1,12,18,66.7,6,41,27,14,31,66,146,1,Matches
340,James Morrison,sct SCO,MF,West Brom,31,1986,2.3,2,1,0,2,0,1,4,25.0,3,1,1,0,1,3,1,0,Matches
341,Victor Moses,ng NGA,"DF,MF",Chelsea,26,1990,23.4,37,29,21,13,3,14,24,58.3,10,29,4,25,15,52,39,2,Matches
342,Steve Mounié,bj BEN,FW,Huddersfield,22,1994,20.6,11,8,2,4,5,0,19,0.0,19,23,3,20,7,18,30,0,Matches
343,Lucas Moura,br BRA,"FW,MF",Tottenham,24,1992,2.3,4,2,3,0,1,1,3,33.3,2,2,0,2,2,6,2,0,Matches
344,Lys Mousset,fr FRA,"FW,MF",Bournemouth,21,1996,6.6,9,5,6,3,0,0,8,0.0,8,5,2,3,3,12,9,0,Matches
345,Jacob Murphy,eng ENG,"MF,FW",Newcastle Utd,22,1995,12.8,13,10,5,4,4,7,27,25.9,20,16,0,16,6,19,13,2,Matches
346,Jamie Murphy,sct SCO,MF,Brighton,27,1989,1.9,2,2,2,0,0,2,4,50.0,2,0,0,0,1,3,3,0,Matches
347,Glenn Murray,eng ENG,FW,Brighton,33,1983,24.4,18,12,4,11,3,2,18,11.1,16,16,4,12,5,23,27,0,Matches
348,Charly Musonda Jr.,be BEL,FW,Chelsea,20,1996,0.4,1,0,0,0,1,1,1,100.0,0,0,0,0,0,1,0,0,Matches
349,Shkodran Mustafi,de GER,DF,Arsenal,25,1992,25.3,64,46,42,18,4,28,54,51.9,26,23,15,8,57,121,175,2,Matches
350,Boaz Myhill,wls WAL,GK,West Brom,34,1982,1.0,0,0,0,0,0,0,0,,0,0,0,0,0,0,1,0,Matches
351,Georges-Kévin N'Koudou,cm CMR,MF,Tottenham,22,1995,0.0,0,0,0,0,0,0,0,,0,0,0,0,0,0,1,0,Matches
352,Georges-Kévin N'Koudou,cm CMR,"MF,FW",Burnley,22,1995,2.5,7,6,5,1,1,3,8,37.5,5,4,0,4,1,8,1,0,Matches
353,Luciano Narsingh,nl NED,"FW,MF",Swansea City,26,1990,6.9,7,5,1,5,1,2,7,28.6,5,7,0,7,3,10,3,0,Matches
354,Kyle Naughton,eng ENG,DF,Swansea City,28,1988,33.7,92,60,49,35,8,54,100,54.0,46,60,13,47,60,152,144,4,Matches
355,Badou Ndiaye,sn SEN,MF,Stoke City,26,1990,12.6,53,28,22,25,6,16,41,39.0,25,21,9,12,13,66,18,0,Matches
356,Wilfred Ndidi,ng NGA,MF,Leicester City,20,1996,32.2,138,89,68,65,5,45,119,37.8,74,67,10,57,51,189,103,2,Matches
357,Reiss Nelson,eng ENG,"FW,MF",Arsenal,17,1999,1.6,4,3,1,1,2,0,0,,0,4,0,4,3,7,0,0,Matches
358,Julien Ngoy,be BEL,MF,Stoke City,19,1997,0.2,1,1,0,1,0,1,2,50.0,1,0,0,0,0,1,0,0,Matches
359,Oumar Niasse,sn SEN,FW,Everton,27,1990,12.1,10,6,2,5,3,4,19,21.1,15,3,2,1,2,12,6,0,Matches
360,Eddie Nketiah,eng ENG,FW,Arsenal,18,1999,0.2,1,1,0,1,0,0,0,,0,0,0,0,0,1,0,0,Matches
361,Lukas Nmecha,de GER,FW,Manchester City,18,1998,0.2,0,0,0,0,0,0,0,,0,0,0,0,0,0,0,0,Matches
362,Mark Noble,eng ENG,MF,West Ham,30,1987,26.7,61,36,32,22,7,16,76,21.1,60,28,10,18,47,108,32,1,Matches
363,Allan Nyom,cm CMR,DF,West Brom,29,1988,25.7,64,39,43,17,4,28,43,65.1,15,20,9,11,27,91,93,0,Matches
364,Aiden O'Neill,au AUS,MF,Burnley,19,1998,0.0,,,,,,,,,,,,,,,,,Matches
365,Michael Obafemi,ie IRL,FW,Southampton,17,2000,0.1,0,0,0,0,0,0,0,,0,0,0,0,0,0,0,0,Matches
366,Pedro Obiang,gq EQG,MF,West Ham,25,1992,17.4,53,34,20,29,4,17,51,33.3,34,37,16,21,24,77,27,1,Matches
367,Angelo Ogbonna,it ITA,DF,West Ham,29,1988,32.0,30,24,18,10,2,8,18,44.4,10,40,27,13,58,88,197,1,Matches
368,Stefano Okaka,it ITA,FW,Watford,27,1989,5.0,6,4,0,6,0,3,6,50.0,3,3,0,3,0,6,0,0,Matches
369,Shinji Okazaki,jp JPN,"FW,MF",Leicester City,31,1986,14.7,25,16,3,18,4,4,28,14.3,24,15,1,14,8,33,6,0,Matches
370,Martin Olsson,se SWE,DF,Swansea City,29,1988,35.0,34,26,18,10,6,12,29,41.4,17,21,4,17,31,65,81,0,Matches
371,Divock Origi,be BEL,FW,Liverpool,22,1995,0.1,0,0,0,0,0,0,0,,0,0,0,0,0,0,0,0,Matches
372,David Ospina,co COL,GK,Arsenal,28,1988,4.2,0,0,0,0,0,0,0,,0,0,0,0,0,0,1,0,Matches
373,Nicolás Otamendi,ar ARG,DF,Manchester City,29,1988,33.0,58,43,35,22,1,19,44,43.2,25,21,10,11,48,106,129,3,Matches
374,Reece Oxford,eng ENG,MF,West Ham,18,1998,0.1,2,1,1,1,0,1,1,100.0,0,0,0,0,0,2,0,0,Matches
375,Alex Oxlade-Chamberlain,eng ENG,DF,Arsenal,23,1993,2.7,5,3,2,2,1,2,3,66.7,1,5,2,3,6,11,8,0,Matches
376,Alex Oxlade-Chamberlain,eng ENG,"MF,FW",Liverpool,23,1993,16.6,32,21,13,14,5,6,21,28.6,15,24,0,24,20,52,14,0,Matches
377,Mesut Özil,de GER,"MF,FW",Arsenal,28,1988,24.0,20,13,6,10,4,5,22,22.7,17,11,1,10,12,32,9,0,Matches
378,Kasey Palmer,jm JAM,"MF,FW",Huddersfield,20,1996,1.9,6,3,2,3,1,2,8,25.0,6,5,0,5,0,6,2,0,Matches
379,Emerson Palmieri,it ITA,DF,Chelsea,22,1994,3.1,6,4,4,2,0,5,5,100.0,0,2,0,2,2,8,10,0,Matches
380,Pedro,es ESP,"MF,FW",Chelsea,30,1987,16.9,20,11,6,8,6,5,18,27.8,13,13,1,12,13,33,7,1,Matches
381,Roberto Pereyra,ar ARG,"MF,FW",Watford,26,1991,18.0,10,8,4,5,1,2,13,15.4,11,16,0,16,9,19,6,0,Matches
382,Ayoze Pérez,es ESP,"MF,FW",Newcastle Utd,24,1993,27.7,39,21,11,15,13,12,54,22.2,42,36,1,35,24,63,28,0,Matches
383,Matt Phillips,sct SCO,"MF,DF",West Brom,26,1991,23.3,27,16,17,5,5,10,29,34.5,19,21,1,20,24,51,43,0,Matches
384,Jordan Pickford,eng ENG,GK,Everton,23,1994,38.0,0,0,0,0,0,0,2,0.0,2,0,0,0,2,2,26,5,Matches
385,Jérémy Pied,fr FRA,DF,Southampton,28,1989,2.0,9,6,8,1,0,6,9,66.7,3,3,2,1,8,17,4,0,Matches
386,Erik Pieters,nl NED,DF,Stoke City,28,1988,30.2,71,47,43,26,2,24,51,47.1,27,70,25,45,61,132,127,5,Matches
387,Paul Pogba,fr FRA,MF,Manchester Utd,24,1993,23.9,33,23,13,15,5,5,33,15.2,28,16,0,16,21,54,26,0,Matches
388,Nick Pope,eng ENG,GK,Burnley,25,1992,34.6,0,0,0,0,0,0,1,0.0,1,0,0,0,0,0,21,0,Matches
389,Alex Pritchard,eng ENG,"MF,FW",Huddersfield,24,1993,11.1,18,8,2,6,10,10,21,47.6,11,6,1,5,5,23,11,0,Matches
390,Sebastian Prödl,at AUT,DF,Watford,30,1987,17.4,22,17,19,3,0,8,15,53.3,7,20,9,11,31,53,92,1,Matches
391,Davy Pröpper,nl NED,MF,Brighton,25,1991,34.7,73,44,35,35,3,18,83,21.7,65,35,11,24,60,133,80,2,Matches
392,Marc Pugh,eng ENG,"MF,FW",Bournemouth,30,1987,10.9,7,3,2,4,1,2,10,20.0,8,6,1,5,13,20,13,2,Matches
393,Jason Puncheon,eng ENG,MF,Crystal Palace,31,1986,7.2,13,4,3,7,3,1,5,20.0,4,3,0,3,5,18,4,0,Matches
394,Collin Quaner,de GER,"FW,MF",Huddersfield,26,1991,14.2,22,15,8,8,6,9,26,34.6,17,24,4,20,11,33,15,0,Matches
395,Sandro Ramírez,es ESP,"FW,MF",Everton,22,1995,3.1,2,1,0,1,1,0,3,0.0,3,1,0,1,1,3,0,0,Matches
396,Aaron Ramsey,wls WAL,MF,Arsenal,26,1990,20.5,35,27,18,17,0,8,44,18.2,36,14,3,11,24,59,6,1,Matches
397,Àngel Rangel,es ESP,DF,Swansea City,34,1982,1.7,4,3,2,2,0,1,3,33.3,2,0,0,0,3,7,4,0,Matches
398,Marcus Rashford,eng ENG,"FW,MF",Manchester Utd,19,1997,20.1,14,11,4,5,5,6,18,33.3,12,18,0,18,8,22,19,0,Matches
399,Nathan Redmond,eng ENG,"FW,MF",Southampton,23,1994,21.6,32,17,16,14,2,12,31,38.7,19,20,0,20,15,47,17,2,Matches
400,Winston Reid,nz NZL,DF,West Ham,29,1988,16.1,11,9,7,4,0,4,15,26.7,11,27,14,13,22,33,104,0,Matches
401,Declan Rice,eng ENG,"DF,MF",West Ham,18,1999,15.9,36,24,25,10,1,15,25,60.0,10,19,13,6,27,63,77,1,Matches
402,Richarlison,br BRA,"FW,MF",Watford,20,1997,31.4,64,44,26,28,10,10,39,25.6,29,39,5,34,24,88,32,1,Matches
403,Jaïro Riedewald,nl NED,"MF,DF",Crystal Palace,20,1996,4.9,11,8,6,4,1,0,2,0.0,2,7,1,6,12,23,13,0,Matches
404,Matt Ritchie,sct SCO,"MF,FW",Newcastle Utd,27,1989,31.2,46,32,22,18,6,14,53,26.4,39,37,5,32,35,81,63,1,Matches
405,Connor Roberts,wls WAL,DF,Swansea City,21,1995,3.0,6,4,5,1,0,3,3,100.0,0,2,0,2,3,9,6,0,Matches
406,Andrew Robertson,sct SCO,DF,Liverpool,23,1994,21.6,31,17,19,9,3,15,29,51.7,14,22,2,20,26,57,56,0,Matches
407,Hal Robson-Kanu,wls WAL,"FW,MF",West Brom,28,1989,9.2,5,4,1,2,2,0,13,0.0,13,9,3,6,4,9,9,0,Matches
408,Jay Rodriguez,eng ENG,"FW,MF",West Brom,28,1989,31.2,31,21,12,11,8,9,50,18.0,41,32,2,30,19,50,41,0,Matches
409,Marcos Rojo,ar ARG,DF,Manchester Utd,27,1990,7.1,7,5,6,0,1,1,8,12.5,7,11,6,5,7,14,56,2,Matches
410,Sergio Romero,ar ARG,GK,Manchester Utd,30,1987,1.0,0,0,0,0,0,0,0,,0,0,0,0,0,0,0,0,Matches
411,Oriol Romeu,es ESP,MF,Southampton,25,1991,32.2,93,64,41,44,8,32,100,32.0,68,59,19,40,69,162,77,2,Matches
412,Salomón Rondón,ve VEN,FW,West Brom,27,1989,30.7,14,6,0,7,7,5,26,19.2,21,27,0,27,14,28,20,0,Matches
413,Wayne Rooney,eng ENG,"MF,FW",Everton,31,1985,25.2,28,19,11,13,4,10,42,23.8,32,25,6,19,16,44,43,2,Matches
414,Danny Rose,eng ENG,DF,Tottenham,27,1990,8.9,15,11,6,7,2,8,15,53.3,7,12,6,6,9,24,15,0,Matches
415,Liam Rosenior,eng ENG,DF,Brighton,33,1984,1.8,4,3,2,1,1,2,5,40.0,3,2,1,1,4,8,7,0,Matches
416,Wayne Routledge,eng ENG,"MF,FW",Swansea City,32,1985,4.8,10,5,2,6,2,2,8,25.0,6,5,0,5,2,12,5,0,Matches
417,Antonio Rüdiger,de GER,DF,Chelsea,24,1993,26.0,31,21,20,10,1,15,31,48.4,16,29,15,14,24,55,115,1,Matches
418,Mathew Ryan,au AUS,GK,Brighton,25,1992,38.0,0,0,0,0,0,0,3,0.0,3,0,0,0,3,3,10,3,Matches
419,Abdelhamid Sabiri,ma MAR,MF,Huddersfield,20,1996,2.4,5,4,2,0,3,1,7,14.3,6,4,0,4,1,6,2,0,Matches
420,Henri Saivet,sn SEN,MF,Newcastle Utd,26,1990,0.9,5,3,4,1,0,2,5,40.0,3,0,0,0,4,9,8,1,Matches
421,Diafra Sakho,sn SEN,FW,West Ham,27,1989,3.4,5,2,1,4,0,0,3,0.0,3,3,0,3,1,6,2,0,Matches
422,Mamadou Sakho,fr FRA,DF,Crystal Palace,27,1990,17.8,21,14,15,5,1,9,16,56.3,7,19,11,8,30,51,101,3,Matches
423,Bakary Sako,ml MLI,"FW,MF",Crystal Palace,29,1988,5.3,7,6,5,0,2,2,9,22.2,7,2,0,2,1,8,2,0,Matches
424,Mohamed Salah,eg EGY,FW,Liverpool,25,1992,32.3,12,6,2,5,5,3,23,13.0,20,10,0,10,5,17,5,0,Matches
425,Renato Sanches,pt POR,MF,Swansea City,19,1997,7.8,12,7,6,6,0,6,18,33.3,12,9,1,8,7,19,5,1,Matches
426,Alexis Sánchez,cl CHI,"MF,FW",Arsenal,28,1988,16.7,20,9,9,4,7,7,32,21.9,25,5,2,3,6,26,1,0,Matches
427,Alexis Sánchez,cl CHI,"FW,MF",Manchester Utd,28,1988,11.6,21,17,10,4,7,4,27,14.8,23,8,0,8,17,38,0,0,Matches
428,Davinson Sánchez,co COL,DF,Tottenham,21,1996,28.2,38,24,28,9,1,18,40,45.0,22,26,10,16,38,76,162,0,Matches
429,Leroy Sané,de GER,FW,Manchester City,21,1996,26.9,27,21,14,7,6,8,22,36.4,14,22,1,21,13,40,6,0,Matches
430,Ezequiel Schelotto,it ITA,DF,Brighton,28,1989,14.6,20,13,14,6,0,12,27,44.4,15,7,3,4,19,39,58,2,Matches
431,Christopher Schindler,de GER,DF,Huddersfield,27,1990,36.3,83,61,56,27,0,24,41,58.5,17,54,30,24,75,158,275,1,Matches
432,Jeffrey Schlupp,gh GHA,"DF,MF",Crystal Palace,24,1992,19.4,57,36,35,20,2,23,43,53.5,20,34,8,26,24,81,67,0,Matches
433,Kasper Schmeichel,dk DEN,GK,Leicester City,30,1986,32.9,1,0,1,0,0,1,3,33.3,2,1,0,1,0,1,18,5,Matches
434,Morgan Schneiderlin,fr FRA,MF,Everton,27,1989,23.7,58,40,34,21,3,15,44,34.1,29,18,7,11,61,119,59,1,Matches
435,Xherdan Shaqiri,ch SUI,"MF,FW",Stoke City,25,1991,33.8,25,17,9,11,5,10,39,25.6,29,9,1,8,16,41,6,2,Matches
436,Luke Shaw,eng ENG,DF,Manchester Utd,22,1995,8.8,18,15,10,7,1,11,18,61.1,7,16,2,14,4,22,22,1,Matches
437,Ryan Shawcross,eng ENG,DF,Stoke City,29,1987,26.3,36,20,25,9,2,13,25,52.0,12,33,23,10,40,76,224,1,Matches
438,Jonjo Shelvey,eng ENG,MF,Newcastle Utd,25,1992,25.2,39,24,17,21,1,8,26,30.8,18,26,5,21,28,67,33,0,Matches
439,Gylfi Sigurðsson,is ISL,"MF,FW",Everton,27,1989,25.1,38,26,15,14,9,16,57,28.1,41,37,7,30,34,72,36,0,Matches
440,Adrien Silva,pt POR,MF,Leicester City,28,1989,8.5,22,13,8,13,1,6,28,21.4,22,12,2,10,14,36,0,0,Matches
441,Bernardo Silva,pt POR,"FW,MF",Manchester City,22,1994,17.0,27,18,11,9,7,6,30,20.0,24,17,1,16,10,37,12,1,Matches
442,David Silva,es ESP,MF,Manchester City,31,1986,27.0,32,21,11,17,4,9,45,20.0,36,28,5,23,18,50,7,0,Matches
443,Danny Simpson,eng ENG,DF,Leicester City,30,1987,25.6,38,22,31,6,1,22,45,48.9,23,31,19,12,34,72,132,1,Matches
444,Jack Simpson,eng ENG,DF,Bournemouth,20,1996,0.8,1,1,1,0,0,0,1,0.0,1,1,0,1,0,1,4,0,Matches
445,Josh Sims,eng ENG,"FW,MF",Southampton,20,1997,1.8,4,3,1,2,1,2,7,28.6,5,5,0,5,1,5,0,0,Matches
446,Jerome Sinclair,eng ENG,"MF,FW",Watford,20,1996,0.3,0,0,0,0,0,0,1,0.0,1,0,0,0,1,1,0,0,Matches
447,Moussa Sissoko,fr FRA,"MF,FW",Tottenham,27,1989,15.4,23,17,14,5,4,9,12,75.0,3,11,1,10,9,32,23,1,Matches
448,Islam Slimani,dz ALG,FW,Leicester City,29,1988,2.8,2,2,1,1,0,1,4,25.0,3,2,0,2,0,2,2,0,Matches
449,Islam Slimani,dz ALG,FW,Newcastle Utd,29,1988,1.5,0,0,0,0,0,0,2,0.0,2,0,0,0,1,1,1,0,Matches
450,Chris Smalling,eng ENG,DF,Manchester Utd,27,1989,28.2,40,25,28,12,0,16,28,57.1,12,32,28,4,63,103,162,1,Matches
451,Adam Smith,eng ENG,"DF,MF",Bournemouth,26,1991,23.0,50,36,33,16,1,24,53,45.3,29,46,8,38,31,81,73,0,Matches
452,Tommy Smith,eng ENG,DF,Huddersfield,25,1992,21.2,38,27,18,14,6,23,36,63.9,13,22,6,16,26,64,80,3,Matches
453,Cédric Soares,pt POR,DF,Southampton,25,1991,31.0,54,34,40,10,4,22,31,71.0,9,32,8,24,24,78,109,2,Matches
454,Ramadan Sobhi,eg EGY,"MF,FW",Stoke City,20,1997,13.8,32,21,17,14,1,11,36,30.6,25,14,0,14,14,46,14,0,Matches
455,Dominic Solanke,eng ENG,FW,Liverpool,19,1997,6.6,7,4,0,6,1,1,4,25.0,3,5,1,4,2,9,9,0,Matches
456,Pape Souaré,sn SEN,DF,Crystal Palace,27,1990,0.1,0,0,0,0,0,0,0,,0,0,0,0,0,0,0,0,Matches
457,Julián Speroni,ar ARG,GK,Crystal Palace,38,1979,11.0,0,0,0,0,0,0,0,,0,0,0,0,1,1,4,0,Matches
458,Kostas Stafylidis,gr GRE,"DF,MF",Stoke City,23,1993,3.7,12,6,6,4,2,6,9,66.7,3,7,2,5,5,17,19,0,Matches
459,Junior Stanislas,eng ENG,"MF,FW",Bournemouth,27,1989,14.3,16,8,8,4,4,7,15,46.7,8,21,6,15,6,22,15,0,Matches
460,Dale Stephens,eng ENG,MF,Brighton,28,1989,36.0,104,62,63,39,2,32,114,28.1,82,53,16,37,63,167,69,1,Matches
461,Jack Stephens,eng ENG,DF,Southampton,23,1994,22.0,29,20,24,5,0,13,25,52.0,12,30,18,12,41,70,108,2,Matches
462,Raheem Sterling,eng ENG,FW,Manchester City,22,1994,28.7,19,14,7,7,5,3,32,9.4,29,24,0,24,9,28,9,0,Matches
463,John Stones,eng ENG,DF,Manchester City,23,1994,14.5,15,11,11,4,0,4,11,36.4,7,8,5,3,19,34,44,0,Matches
464,Daniel Sturridge,eng ENG,FW,West Brom,27,1989,1.3,0,0,0,0,0,0,0,,0,0,0,0,0,0,0,0,Matches
465,Daniel Sturridge,eng ENG,FW,Liverpool,27,1989,4.8,0,0,0,0,0,0,1,0.0,1,1,0,1,0,0,1,0,Matches
466,Ki Sung-yueng,kr KOR,MF,Swansea City,28,1989,20.8,25,18,10,13,2,4,16,25.0,12,16,1,15,32,57,23,0,Matches
467,Andrew Surman,eng ENG,MF,Bournemouth,30,1986,20.6,16,12,5,8,3,6,23,26.1,17,33,12,21,16,32,52,2,Matches
468,Markus Suttner,at AUT,DF,Brighton,30,1987,13.1,25,15,18,4,3,10,22,45.5,12,16,2,14,12,37,49,1,Matches
469,Lasse Sørensen,dk DEN,MF,Stoke City,17,1999,0.8,2,2,2,0,0,1,5,20.0,4,2,0,2,0,2,3,0,Matches
470,Alexander Sørloth,no NOR,FW,Crystal Palace,21,1995,4.0,6,3,1,4,1,4,12,33.3,8,5,0,5,2,8,5,0,Matches
471,Dušan Tadić,rs SRB,"MF,FW",Southampton,28,1988,31.0,46,29,16,22,8,11,35,31.4,24,38,2,36,19,65,29,1,Matches
472,Matt Targett,eng ENG,DF,Southampton,21,1995,1.8,6,3,5,0,1,1,3,33.3,2,3,2,1,3,9,7,1,Matches
473,James Tarkowski,eng ENG,DF,Burnley,24,1992,31.0,46,26,36,10,0,17,38,44.7,21,55,43,12,50,96,223,2,Matches
474,Charlie Taylor,eng ENG,DF,Burnley,23,1993,10.6,16,4,9,6,1,7,12,58.3,5,13,5,8,15,31,52,0,Matches
475,James Tomkins,eng ENG,DF,Crystal Palace,28,1989,26.5,47,26,36,10,1,16,31,51.6,15,24,12,12,63,110,216,1,Matches
476,Cenk Tosun,tr TUR,FW,Everton,26,1991,11.0,6,3,2,2,2,1,11,9.1,10,9,4,5,1,7,13,0,Matches
477,Yaya Touré,ci CIV,MF,Manchester City,34,1983,2.6,2,2,1,0,1,1,1,100.0,0,3,1,2,5,7,4,0,Matches
478,Andros Townsend,eng ENG,"FW,MF",Crystal Palace,26,1991,34.7,60,34,35,12,13,24,75,32.0,51,49,1,48,35,95,28,0,Matches
479,Kieran Trippier,eng ENG,DF,Tottenham,26,1990,21.3,52,30,29,21,2,21,44,47.7,23,31,6,25,20,72,53,1,Matches
480,Axel Tuanzebe,cd COD,FW,Manchester Utd,19,1997,0.0,0,0,0,0,0,0,0,,0,0,0,0,0,0,0,0,Matches
481,Josh Tymon,eng ENG,DF,Stoke City,18,1999,1.8,5,1,4,1,0,2,3,66.7,1,1,0,1,1,6,3,0,Matches
482,Leonardo Ulloa,ar ARG,FW,Leicester City,31,1986,0.2,1,0,0,0,1,0,0,,0,0,0,0,0,1,1,0,Matches
483,Leonardo Ulloa,ar ARG,FW,Brighton,31,1986,3.0,3,1,0,1,2,1,7,14.3,6,1,0,1,0,3,3,0,Matches
484,Antonio Valencia,ec ECU,DF,Manchester Utd,31,1985,30.4,57,32,21,28,8,16,36,44.4,20,47,6,41,48,105,80,0,Matches
485,Virgil van Dijk,nl NED,DF,Southampton,26,1991,11.0,10,7,6,2,2,2,3,66.7,1,14,13,1,29,39,81,1,Matches
486,Virgil van Dijk,nl NED,DF,Liverpool,26,1991,14.0,15,8,7,7,1,4,5,80.0,1,8,2,6,18,33,80,1,Matches
487,Jamie Vardy,eng ENG,FW,Leicester City,30,1987,36.1,15,9,3,7,5,1,8,12.5,7,21,1,20,2,17,17,0,Matches
488,Jan Vertonghen,be BEL,DF,Tottenham,30,1987,35.6,64,41,40,20,4,25,36,69.4,11,29,11,18,60,124,177,0,Matches
489,Nikola Vlašić,hr CRO,"MF,FW",Everton,19,1997,6.4,9,5,3,6,0,2,9,22.2,7,14,2,12,9,18,10,0,Matches
490,Sam Vokes,wls WAL,FW,Burnley,27,1989,11.1,3,1,1,2,0,0,3,0.0,3,6,2,4,3,6,15,0,Matches
491,Michel Vorm,nl NED,GK,Tottenham,33,1983,1.0,0,0,0,0,0,0,0,,0,0,0,0,0,0,1,0,Matches
492,Molla Wagué,ml MLI,DF,Watford,26,1991,4.9,5,3,3,2,0,2,5,40.0,3,1,0,1,9,14,30,0,Matches
493,Theo Walcott,eng ENG,"FW,MF",Arsenal,28,1989,0.8,1,0,1,0,0,0,0,,0,0,0,0,1,2,0,0,Matches
494,Theo Walcott,eng ENG,FW,Everton,28,1989,12.8,27,19,12,13,2,7,15,46.7,8,9,0,9,8,35,12,0,Matches
495,Kyle Walker,eng ENG,DF,Manchester City,27,1990,30.9,47,31,20,21,6,18,31,58.1,13,21,2,19,29,76,75,2,Matches
496,Kyle Walker-Peters,eng ENG,DF,Tottenham,20,1997,2.1,5,4,4,1,0,2,4,50.0,2,2,0,2,3,8,8,0,Matches
497,Jonathan Walters,ie IRL,FW,Burnley,33,1983,0.4,0,0,0,0,0,0,0,,0,0,0,0,0,0,1,0,Matches
498,Aaron Wan-Bissaka,eng ENG,DF,Crystal Palace,19,1997,7.0,30,19,20,7,3,15,19,78.9,4,18,7,11,15,45,45,0,Matches
499,Victor Wanyama,ke KEN,MF,Tottenham,26,1991,9.4,30,20,13,16,1,14,31,45.2,17,13,3,10,10,40,20,1,Matches
500,Joel Ward,eng ENG,DF,Crystal Palace,27,1989,17.9,35,30,23,12,0,16,28,57.1,12,27,11,16,28,63,76,0,Matches
501,Stephen Ward,ie IRL,DF,Burnley,31,1985,27.3,39,31,27,8,4,20,42,47.6,22,27,12,15,42,81,126,0,Matches
502,James Ward-Prowse,eng ENG,"FW,MF",Southampton,22,1994,19.1,23,16,9,11,3,3,27,11.1,24,29,1,28,8,31,31,0,Matches
503,Ben Watson,eng ENG,MF,Watford,32,1985,5.1,19,9,9,9,1,10,31,32.3,21,6,1,5,7,26,10,0,Matches
504,Danny Welbeck,eng ENG,"FW,MF",Arsenal,26,1990,13.3,20,13,9,5,6,4,12,33.3,8,22,1,21,11,31,13,0,Matches
505,Nahki Wells,bm BER,"FW,MF",Burnley,27,1990,0.6,4,3,0,3,1,1,1,100.0,0,2,0,2,0,4,0,0,Matches
506,Ashley Westwood,eng ENG,MF,Burnley,27,1990,12.3,13,10,10,3,0,2,16,12.5,14,17,9,8,19,32,16,0,Matches
507,Dean Whitehead,eng ENG,MF,Huddersfield,35,1982,0.8,0,0,0,0,0,0,1,0.0,1,1,0,1,2,2,0,0,Matches
508,Georginio Wijnaldum,nl NED,MF,Liverpool,26,1990,26.5,34,23,13,16,5,11,23,47.8,12,20,2,18,25,59,20,0,Matches
509,Ashley Williams,wls WAL,DF,Everton,32,1984,20.4,23,13,17,6,0,9,18,50.0,9,31,23,8,36,59,173,3,Matches
510,Danny Williams,us USA,MF,Huddersfield,28,1989,12.5,23,14,13,9,1,7,22,31.8,15,12,2,10,26,49,27,0,Matches
511,Willian,br BRA,"MF,FW",Chelsea,28,1988,21.0,22,17,7,12,3,0,16,0.0,16,13,1,12,10,32,10,0,Matches
512,Joe Willock,eng ENG,MF,Arsenal,17,1999,0.9,4,2,4,0,0,1,1,100.0,0,3,0,3,1,5,2,0,Matches
513,Jack Wilshere,eng ENG,MF,Arsenal,25,1992,13.3,15,10,3,7,5,4,20,20.0,16,10,2,8,8,23,5,0,Matches
514,Callum Wilson,eng ENG,FW,Bournemouth,25,1992,22.0,9,5,2,6,1,1,14,7.1,13,15,3,12,3,12,15,0,Matches
515,Kevin Wimmer,at AUT,DF,Stoke City,24,1992,14.7,24,17,17,7,0,9,20,45.0,11,25,12,13,30,54,88,0,Matches
516,Harry Winks,eng ENG,MF,Tottenham,21,1996,8.6,15,12,8,5,2,8,16,50.0,8,12,2,10,11,26,10,1,Matches
517,Chris Wood,nz NZL,FW,Burnley,25,1991,18.0,7,3,2,3,2,3,13,23.1,10,12,4,8,0,7,16,0,Matches
518,Ben Woodburn,wls WAL,FW,Liverpool,17,1999,0.1,0,0,0,0,0,0,0,,0,0,0,0,0,0,0,0,Matches
519,Granit Xhaka,ch SUI,MF,Arsenal,24,1992,36.2,78,57,35,40,3,26,69,37.7,43,30,9,21,37,115,68,4,Matches
520,Claudio Yacob,ar ARG,MF,West Brom,30,1987,10.0,36,27,23,13,0,13,27,48.1,14,14,6,8,16,52,25,2,Matches
521,DeAndre Yedlin,us USA,DF,Newcastle Utd,24,1993,31.6,57,33,39,14,4,26,54,48.1,28,37,7,30,44,101,114,0,Matches
522,Maya Yoshida,jp JPN,DF,Southampton,28,1988,22.8,27,20,22,5,0,18,25,72.0,7,32,14,18,41,68,133,2,Matches
523,Ashley Young,eng ENG,DF,Manchester Utd,32,1985,27.1,53,32,30,17,6,18,47,38.3,29,24,5,19,57,110,86,1,Matches
524,Pablo Zabaleta,ar ARG,"DF,MF",West Ham,32,1985,36.5,96,67,54,28,14,48,98,49.0,50,72,13,59,61,157,152,0,Matches
525,Wilfried Zaha,ci CIV,"FW,MF",Crystal Palace,24,1992,28.3,30,23,9,13,8,4,23,17.4,19,24,0,24,7,37,4,0,Matches
526,Davide Zappacosta,it ITA,"DF,MF",Chelsea,25,1992,12.2,26,11,14,9,3,11,25,44.0,14,11,2,9,6,32,26,0,Matches
527,Marvin Zeegelaar,nl NED,DF,Watford,26,1990,11.0,23,18,15,3,5,11,24,45.8,13,5,1,4,20,43,30,0,Matches
528,Oleksandr Zinchenko,ua UKR,DF,Manchester City,20,1996,5.9,23,16,11,9,3,7,13,53.8,6,3,0,3,6,29,7,0,Matches
529,Kurt Zouma,fr FRA,DF,Stoke City,22,1994,32.1,50,38,35,13,2,21,28,75.0,7,42,23,19,61,111,246,2,Matches
1,Patrick van Aanholt,nl NED,DF,Crystal Palace,29,1990,19.7,35,22,18,17,0,19,43,44.2,24,18,6,12,30,65,40,2,Matches
2,Tammy Abraham,eng ENG,FW,Chelsea,22,1997,11.6,7,5,3,3,1,1,7,14.3,6,6,0,6,5,12,17,0,Matches
3,Che Adams,sct SCO,FW,Southampton,24,1996,29.6,25,16,4,15,6,6,17,35.3,11,20,2,18,4,29,19,1,Matches
4,Tosin Adarabioyo,eng ENG,DF,Fulham,22,1997,32.8,37,19,30,6,1,19,40,47.5,21,26,20,6,42,79,197,2,Matches
5,Adrián,es ESP,GK,Liverpool,33,1987,3.0,0,0,0,0,0,0,0,,0,0,0,0,0,0,3,1,Matches
6,Sergio Agüero,ar ARG,FW,Manchester City,32,1988,6.2,4,1,0,2,2,2,11,18.2,9,2,0,2,2,6,0,0,Matches
7,Ola Aina,ng NGA,DF,Fulham,23,1996,29.6,37,20,22,7,8,21,43,48.8,22,22,6,16,45,82,94,2,Matches
8,Rayan Aït-Nouri,dz ALG,DF,Wolves,19,2001,15.6,29,16,18,10,1,13,27,48.1,14,14,1,13,15,44,25,0,Matches
9,Semi Ajayi,ng NGA,DF,West Brom,26,1993,30.9,40,14,34,6,0,23,41,56.1,18,51,32,19,42,82,122,2,Matches
10,Nathan Aké,nl NED,DF,Manchester City,25,1995,8.9,10,5,3,6,1,3,4,75.0,1,2,1,1,9,19,23,0,Matches
11,Marc Albrighton,eng ENG,"DF,FW",Leicester City,30,1989,19.4,33,19,14,15,4,16,45,35.6,29,29,3,26,17,50,27,1,Matches
12,Thiago Alcántara,es ESP,MF,Liverpool,29,1991,20.6,61,36,20,30,11,17,49,34.7,32,26,0,26,30,91,14,0,Matches
13,Toby Alderweireld,be BEL,DF,Tottenham,31,1989,24.9,35,22,22,11,2,18,30,60.0,12,40,28,12,10,45,121,0,Matches
14,Rúnar Alex Rúnarsson,is ISL,GK,Arsenal,25,1995,0.2,0,0,0,0,0,0,0,,0,0,0,0,0,0,0,0,Matches
15,Trent Alexander-Arnold,eng ENG,DF,Liverpool,21,1998,33.7,56,33,31,18,7,36,56,64.3,20,24,3,21,49,105,50,3,Matches
16,Ezgjan Alioski,mk MKD,"DF,MF",Leeds United,28,1992,27.3,74,31,38,28,8,32,74,43.2,42,17,2,15,23,97,50,2,Matches
17,Alisson,br BRA,GK,Liverpool,27,1992,33.0,3,2,3,0,0,3,4,75.0,1,0,0,0,2,5,26,7,Matches
18,Allan,br BRA,MF,Everton,29,1991,22.8,80,45,39,37,4,28,95,29.5,67,31,12,19,19,99,25,1,Matches
19,Dele Alli,eng ENG,MF,Tottenham,24,1996,6.9,18,11,8,6,4,7,19,36.8,12,9,0,9,7,25,3,0,Matches
20,Miguel Almirón,py PAR,"MF,FW",Newcastle Utd,26,1994,27.0,49,29,21,25,3,14,56,25.0,42,23,4,19,25,74,20,1,Matches
21,Marcos Alonso,es ESP,DF,Chelsea,29,1990,10.7,13,3,6,4,3,7,14,50.0,7,12,1,11,12,25,30,0,Matches
22,Steven Alzate,co COL,MF,Brighton,21,1998,10.0,17,8,10,4,3,6,15,40.0,9,8,1,7,8,25,10,0,Matches
23,Daniel Amartey,gh GHA,DF,Leicester City,25,1994,8.0,11,7,6,4,1,8,12,66.7,4,8,4,4,12,23,26,0,Matches
24,Ethan Ampadu,wls WAL,"DF,MF",Sheffield Utd,19,2000,23.2,57,36,31,24,2,20,46,43.5,26,40,19,21,49,106,87,3,Matches
25,Joachim Andersen,dk DEN,DF,Fulham,24,1996,30.3,33,19,18,11,4,15,28,53.6,13,24,13,11,44,77,151,1,Matches
26,Elliot Anderson,eng ENG,MF,Newcastle Utd,17,2002,0.0,0,0,0,0,0,0,0,,0,0,0,0,0,0,0,0,Matches
27,Felipe Anderson,br BRA,"FW,MF",West Ham,27,1993,0.0,1,1,0,1,0,0,0,,0,0,0,0,0,1,0,0,Matches
28,Michail Antonio,jm JAM,FW,West Ham,30,1990,21.9,7,4,1,5,1,1,7,14.3,6,20,3,17,7,14,7,0,Matches
29,Alphonse Areola,fr FRA,GK,Fulham,27,1993,36.0,1,0,1,0,0,1,5,20.0,4,0,0,0,1,2,13,3,Matches
30,Stuart Armstrong,sct SCO,MF,Southampton,28,1992,30.7,60,41,19,32,9,27,75,36.0,48,26,1,25,24,84,19,0,Matches
31,Kepa Arrizabalaga,es ESP,GK,Chelsea,25,1994,6.5,0,0,0,0,0,0,1,0.0,1,0,0,0,0,0,0,3,Matches
32,Pierre-Emerick Aubameyang,ga GAB,FW,Arsenal,31,1989,25.9,12,8,7,4,1,3,20,15.0,17,18,0,18,7,19,17,0,Matches
33,Serge Aurier,ci CIV,DF,Tottenham,27,1992,17.8,55,33,33,17,5,15,40,37.5,25,28,5,23,19,74,44,3,Matches
34,Charlie Austin,eng ENG,"FW,MF",West Brom,31,1989,1.5,4,2,1,2,1,1,3,33.3,2,0,0,0,3,7,4,0,Matches
35,Jordan Ayew,gh GHA,"FW,MF",Crystal Palace,28,1991,23.3,38,26,8,16,14,16,44,36.4,28,28,2,26,16,54,12,0,Matches
36,Luke Ayling,eng ENG,DF,Leeds United,28,1991,37.8,108,61,69,30,9,49,87,56.3,38,53,36,17,36,144,96,5,Matches
37,César Azpilicueta,es ESP,DF,Chelsea,30,1989,24.3,53,28,22,24,7,19,37,51.4,18,30,5,25,28,81,62,2,Matches
38,Eric Bailly,ci CIV,DF,Manchester Utd,26,1994,10.2,5,5,3,1,1,0,1,0.0,1,13,11,2,13,18,36,2,Matches
39,Fabián Balbuena,py PAR,DF,West Ham,28,1991,13.3,24,12,23,1,0,14,23,60.9,9,23,6,17,25,49,63,0,Matches
40,George Baldock,gr GRE,DF,Sheffield Utd,27,1993,31.0,47,34,28,14,5,21,50,42.0,29,26,7,19,25,72,70,1,Matches
41,Gareth Bale,wls WAL,FW,Tottenham,31,1989,10.2,17,10,4,9,4,7,14,50.0,7,13,2,11,8,25,16,0,Matches
42,Patrick Bamford,eng ENG,FW,Leeds United,26,1993,33.9,21,9,2,11,8,8,27,29.6,19,14,4,10,10,31,37,0,Matches
43,Phil Bardsley,sct SCO,DF,Burnley,35,1985,3.0,6,5,4,2,0,3,6,50.0,3,3,1,2,6,12,12,0,Matches
44,Ross Barkley,eng ENG,MF,Aston Villa,26,1993,17.0,6,2,2,4,0,3,15,20.0,12,9,1,8,5,11,6,1,Matches
45,Ross Barkley,eng ENG,"FW,MF",Chelsea,26,1993,0.5,0,0,0,0,0,0,0,,0,0,0,0,0,0,0,0,Matches
46,Ashley Barnes,eng ENG,FW,Burnley,30,1989,14.8,12,6,2,6,4,3,13,23.1,10,14,2,12,5,17,11,0,Matches
47,Harvey Barnes,eng ENG,"FW,MF",Leicester City,22,1997,21.6,19,9,11,3,5,5,22,22.7,17,16,3,13,8,27,11,0,Matches
48,Kyle Bartley,eng ENG,DF,West Brom,29,1991,28.7,27,16,14,10,3,11,23,47.8,12,50,35,15,38,65,159,1,Matches
49,Chris Basham,eng ENG,"DF,MF",Sheffield Utd,32,1988,28.6,69,42,41,23,5,41,67,61.2,26,36,15,21,49,118,105,1,Matches
50,Michy Batshuayi,be BEL,FW,Crystal Palace,26,1993,8.1,5,3,1,2,2,1,9,11.1,8,5,1,4,4,9,5,0,Matches
51,Jan Bednarek,pl POL,DF,Southampton,24,1996,34.4,37,19,25,11,1,25,49,51.0,24,44,27,17,84,121,132,0,Matches
52,Donny van de Beek,nl NED,"MF,FW",Manchester Utd,23,1997,5.8,15,10,2,11,2,7,15,46.7,8,10,1,9,6,21,7,0,Matches
53,Héctor Bellerín,es ESP,"DF,MF",Arsenal,25,1995,23.2,29,19,14,12,3,12,41,29.3,29,26,8,18,33,62,33,0,Matches
54,Saïd Benrahma,dz ALG,"FW,MF",West Ham,24,1995,15.5,24,15,8,11,5,8,28,28.6,20,10,0,10,8,32,8,0,Matches
55,Josh Benson,eng ENG,MF,Burnley,20,1999,2.9,5,1,3,0,2,1,6,16.7,5,3,0,3,3,8,2,0,Matches
56,Christian Benteke,be BEL,FW,Crystal Palace,29,1990,20.2,15,7,1,7,7,2,9,22.2,7,17,6,11,4,19,39,0,Matches
57,Gaetano Berardi,ch SUI,DF,Leeds United,31,1988,1.3,2,2,1,0,1,0,0,,0,2,1,1,1,3,2,0,Matches
58,Jóhann Berg Guðmundsson,is ISL,MF,Burnley,29,1990,15.1,19,11,6,9,4,11,23,47.8,12,11,2,9,17,36,19,0,Matches
59,Sander Berge,no NOR,MF,Sheffield Utd,22,1998,12.4,16,7,8,5,3,7,15,46.7,8,11,2,9,4,20,18,0,Matches
60,Steven Bergwijn,nl NED,"FW,MF",Tottenham,22,1997,13.4,15,7,8,3,4,7,20,35.0,13,7,1,6,5,20,9,0,Matches
61,Bernard,br BRA,"MF,FW",Everton,27,1992,5.1,8,3,3,3,2,7,15,46.7,8,5,0,5,8,16,6,0,Matches
62,Bernardo,br BRA,"DF,MF",Brighton,25,1995,2.3,10,8,8,1,1,4,6,66.7,2,2,0,2,1,11,1,0,Matches
63,Ryan Bertrand,eng ENG,DF,Southampton,30,1989,28.9,60,32,26,27,7,30,48,62.5,18,19,1,18,30,90,41,1,Matches
64,Yves Bissouma,ml MLI,MF,Brighton,23,1996,34.6,104,68,50,48,6,33,67,49.3,34,42,6,36,64,168,67,0,Matches
65,Jayden Bogle,eng ENG,"DF,MF",Sheffield Utd,20,2000,12.3,33,23,21,10,2,20,39,51.3,19,14,4,10,14,47,22,0,Matches
66,Willy Boly,ci CIV,DF,Wolves,29,1991,20.9,33,20,26,7,0,13,24,54.2,11,18,12,6,32,65,84,1,Matches
67,Jarrod Bowen,eng ENG,"FW,MF",West Ham,23,1996,28.5,26,15,12,7,7,10,29,34.5,19,19,1,18,22,48,10,0,Matches
68,Robbie Brady,ie IRL,MF,Burnley,28,1992,11.7,22,15,12,6,4,12,35,34.3,23,16,0,16,9,31,29,1,Matches
69,Rhian Brewster,eng ENG,"FW,MF",Sheffield Utd,20,2000,12.5,8,5,1,4,3,1,13,7.7,12,15,2,13,5,13,5,0,Matches
70,Nathan Broadhead,wls WAL,FW,Everton,22,1998,0.0,1,1,0,1,0,0,0,,0,0,0,0,0,1,0,0,Matches
71,Josh Brownhill,eng ENG,MF,Burnley,24,1995,31.3,45,27,9,29,7,15,44,34.1,29,33,11,22,69,114,39,0,Matches
72,Joe Bryan,eng ENG,"DF,MF",Fulham,26,1993,7.4,15,8,7,5,3,7,12,58.3,5,8,2,6,14,29,16,0,Matches
73,Kean Bryan,eng ENG,DF,Sheffield Utd,23,1996,11.2,20,10,9,11,0,9,19,47.4,10,16,10,6,13,33,39,1,Matches
74,Oliver Burke,sct SCO,FW,Sheffield Utd,23,1997,14.1,16,8,6,9,1,5,24,20.8,19,24,0,24,2,18,6,0,Matches
75,Dan Burn,eng ENG,DF,Brighton,28,1992,22.9,50,26,33,14,3,27,53,50.9,26,30,7,23,31,81,75,0,Matches
76,Jack Butland,eng ENG,GK,Crystal Palace,27,1993,1.0,0,0,0,0,0,0,0,,0,0,0,0,0,0,0,0,Matches
77,David Button,eng ENG,GK,West Brom,31,1989,1.0,0,0,0,0,0,0,0,,0,0,0,0,0,0,0,0,Matches
78,Oskar Buur,dk DEN,DF,Wolves,22,1998,0.2,0,0,0,0,0,0,2,0.0,2,0,0,0,0,0,0,0,Matches
79,Willy Caballero,ar ARG,GK,Chelsea,38,1981,1.0,0,0,0,0,0,0,0,,0,0,0,0,0,0,0,0,Matches
80,Gary Cahill,eng ENG,DF,Crystal Palace,34,1985,20.0,13,9,10,3,0,7,11,63.6,4,27,22,5,13,26,88,0,Matches
81,Tom Cairney,sct SCO,MF,Fulham,29,1991,8.4,9,3,1,4,4,1,4,25.0,3,6,0,6,0,9,3,0,Matches
82,Dominic Calvert-Lewin,eng ENG,FW,Everton,23,1997,31.9,17,8,1,8,8,6,12,50.0,6,22,6,16,6,23,33,0,Matches
83,João Cancelo,pt POR,"DF,MF",Manchester City,26,1994,25.5,68,41,42,19,7,43,83,51.8,40,23,2,21,41,109,33,2,Matches
84,Andy Carroll,eng ENG,FW,Newcastle Utd,31,1989,4.4,3,1,1,1,1,1,8,12.5,7,1,0,1,0,3,14,0,Matches
85,Scott Carson,eng ENG,GK,Manchester City,34,1985,1.0,0,0,0,0,0,0,0,,0,0,0,0,0,0,0,0,Matches
86,Fabio Carvalho,pt POR,"MF,FW",Fulham,17,2002,2.8,9,6,4,4,1,5,9,55.6,4,2,0,2,1,10,1,1,Matches
87,Matty Cash,pl POL,DF,Aston Villa,22,1997,26.4,71,40,43,22,6,41,74,55.4,33,50,11,39,60,131,95,0,Matches
88,Kiko Casilla,es ESP,GK,Leeds United,33,1986,3.0,0,0,0,0,0,0,0,,0,0,0,0,0,0,0,0,Matches
89,Timothy Castagne,be BEL,DF,Leicester City,24,1995,26.1,52,32,29,18,5,24,44,54.5,20,29,5,24,29,81,62,1,Matches
90,Jonny Castro,es ESP,"MF,DF",Wolves,26,1994,5.5,11,5,6,4,1,6,13,46.2,7,9,3,6,9,20,7,0,Matches
91,Ivan Cavaleiro,pt POR,FW,Fulham,26,1993,27.5,23,14,9,11,3,12,34,35.3,22,25,1,24,19,42,14,0,Matches
92,Edinson Cavani,uy URU,FW,Manchester Utd,33,1987,15.3,12,8,1,8,3,2,13,15.4,11,2,0,2,6,18,11,0,Matches
93,Dani Ceballos,es ESP,MF,Arsenal,23,1996,17.9,37,22,20,11,6,21,51,41.2,30,23,6,17,35,72,14,1,Matches
94,Calum Chambers,eng ENG,DF,Arsenal,25,1995,8.4,7,3,3,2,2,3,8,37.5,5,6,2,4,10,17,37,0,Matches
95,Ben Chilwell,eng ENG,DF,Chelsea,23,1996,25.4,42,22,16,22,4,15,33,45.5,18,28,3,25,24,66,58,0,Matches
96,Hamza Choudhury,eng ENG,MF,Leicester City,22,1997,3.5,8,7,3,5,0,4,10,40.0,6,4,1,3,4,12,9,1,Matches
97,Andreas Christensen,dk DEN,DF,Chelsea,24,1996,15.2,11,6,8,3,0,0,8,0.0,8,19,14,5,20,31,51,1,Matches
98,Carney Chukwuemeka,eng ENG,"MF,FW",Aston Villa,16,2003,0.2,2,2,1,0,1,1,3,33.3,2,0,0,0,0,2,0,0,Matches
99,Ciaran Clark,ie IRL,DF,Newcastle Utd,30,1989,21.0,24,14,15,6,3,6,13,46.2,7,27,20,7,29,53,104,1,Matches
100,Nathaniel Clyne,eng ENG,DF,Crystal Palace,29,1991,12.7,17,10,8,8,1,9,16,56.3,7,7,2,5,18,35,25,1,Matches
101,Conor Coady,eng ENG,DF,Wolves,27,1993,36.7,35,23,25,10,0,19,35,54.3,16,40,32,8,27,62,134,2,Matches
102,Séamus Coleman,ie IRL,"DF,MF",Everton,31,1988,17.9,39,26,21,14,4,21,30,70.0,9,22,6,16,13,52,37,2,Matches
103,Aaron Connolly,ie IRL,FW,Brighton,20,2000,8.8,6,3,1,3,2,0,2,0.0,2,4,0,4,0,6,2,0,Matches
104,Liam Cooper,sct SCO,DF,Leeds United,28,1991,24.3,68,45,39,27,2,37,59,62.7,22,39,32,7,61,129,70,1,Matches
105,Theo Corbeanu,ca CAN,FW,Wolves,18,2002,0.1,2,1,0,2,0,1,1,100.0,0,0,0,0,1,3,0,0,Matches
106,Jack Cork,eng ENG,MF,Burnley,31,1989,15.0,26,10,5,17,4,11,31,35.5,20,15,4,11,16,42,20,0,Matches
107,Hélder Costa,ao ANG,"MF,FW",Leeds United,26,1994,12.8,25,11,12,5,8,11,32,34.4,21,11,0,11,3,28,5,1,Matches
108,Vladimír Coufal,cz CZE,DF,West Ham,27,1992,33.9,73,36,50,15,8,52,89,58.4,37,41,7,34,41,114,102,1,Matches
109,Aaron Cresswell,eng ENG,DF,West Ham,30,1989,35.2,32,13,15,15,2,18,32,56.3,14,29,14,15,32,64,79,2,Matches
110,Patrick Cutrone,it ITA,FW,Wolves,22,1998,0.3,0,0,0,0,0,0,0,,0,0,0,0,0,0,0,0,Matches
111,Stuart Dallas,nir NIR,"MF,DF",Leeds United,29,1991,37.9,74,45,46,22,6,30,88,34.1,58,41,3,38,44,118,52,1,Matches
112,Scott Dann,eng ENG,DF,Crystal Palace,33,1987,15.0,6,4,5,1,0,4,11,36.4,7,16,14,2,18,24,59,1,Matches
113,Karl Darlow,wls WAL,GK,Newcastle Utd,29,1990,25.0,0,0,0,0,0,0,0,,0,0,0,0,0,0,17,0,Matches
114,Ben Davies,wls WAL,DF,Tottenham,27,1993,15.0,27,17,10,11,6,13,30,43.3,17,10,5,5,18,45,49,2,Matches
115,Tom Davies,eng ENG,MF,Everton,22,1998,15.8,31,18,17,12,2,16,39,41.0,23,15,9,6,34,65,21,2,Matches
116,Keinan Davis,eng ENG,"FW,MF",Aston Villa,22,1998,3.1,2,1,1,0,1,0,1,0.0,1,1,0,1,0,2,2,0,Matches
117,Leif Davis,eng ENG,DF,Leeds United,20,2000,0.4,0,0,0,0,0,0,3,0.0,3,1,0,1,1,1,0,0,Matches
118,Craig Dawson,eng ENG,DF,West Ham,30,1990,21.4,11,8,7,4,0,5,12,41.7,7,26,22,4,32,43,88,3,Matches
119,Kevin De Bruyne,be BEL,MF,Manchester City,29,1991,22.2,34,21,6,18,10,13,48,27.1,35,26,1,25,9,43,10,0,Matches
120,Liam Delap,eng ENG,FW,Manchester City,17,2003,0.4,0,0,0,0,0,0,0,,0,0,0,0,0,0,0,0,Matches
121,Fabian Delph,eng ENG,"MF,DF",Everton,30,1989,3.0,5,2,3,2,0,1,3,33.3,2,2,0,2,4,9,8,1,Matches
122,Leander Dendoncker,be BEL,"MF,DF",Wolves,25,1995,27.8,54,29,29,22,3,31,60,51.7,29,38,15,23,27,81,52,2,Matches
123,Mbaye Diagne,sn SEN,FW,West Brom,28,1991,13.2,4,3,3,0,1,1,4,25.0,3,2,1,1,1,5,16,0,Matches
124,Amad Diallo,ci CIV,FW,Manchester Utd,18,2002,1.8,3,3,1,2,0,0,0,,0,2,1,1,0,3,1,0,Matches
125,Ibrahima Diallo,fr FRA,MF,Southampton,21,1999,11.3,29,16,11,17,1,9,16,56.3,7,10,1,9,10,39,12,2,Matches
126,Grady Diangana,cd COD,"MF,FW",West Brom,22,1998,13.7,35,19,19,9,7,19,43,44.2,24,16,2,14,16,51,9,0,Matches
127,Rúben Dias,pt POR,DF,Manchester City,23,1997,31.6,24,13,13,8,3,4,16,25.0,12,31,23,8,35,59,92,0,Matches
128,Eric Dier,eng ENG,DF,Tottenham,26,1994,28.0,23,14,13,10,0,11,18,61.1,7,37,31,6,23,46,123,3,Matches
129,Lucas Digne,fr FRA,"DF,MF",Everton,27,1993,29.8,63,38,40,16,7,29,54,53.7,25,42,4,38,31,94,87,0,Matches
130,Issa Diop,fr FRA,DF,West Ham,23,1997,15.3,20,14,12,8,0,7,18,38.9,11,32,22,10,22,42,59,0,Matches
131,Moussa Djenepo,ml MLI,MF,Southampton,22,1998,13.8,52,27,27,17,8,28,63,44.4,35,24,2,22,10,62,14,0,Matches
132,Matt Doherty,ie IRL,DF,Tottenham,28,1992,13.8,29,15,15,10,4,13,33,39.4,20,20,5,15,23,52,46,0,Matches
133,Abdoulaye Doucouré,ml MLI,MF,Everton,27,1993,27.1,52,32,25,19,8,14,43,32.6,29,24,7,17,39,91,31,1,Matches
134,Martin Dúbravka,sk SVK,GK,Newcastle Utd,31,1989,13.0,0,0,0,0,0,0,0,,0,0,0,0,0,0,3,0,Matches
135,Paul Dummett,wls WAL,DF,Newcastle Utd,28,1991,13.9,16,7,11,5,0,13,21,61.9,8,12,7,5,16,32,74,0,Matches
136,Lewis Dunk,eng ENG,DF,Brighton,28,1991,32.6,30,15,20,8,2,16,23,69.6,7,29,20,9,32,62,106,0,Matches
137,Jimmy Dunne,ie IRL,DF,Burnley,22,1997,3.0,3,3,2,1,0,1,2,50.0,1,3,2,1,6,9,16,1,Matches
138,Ederson,br BRA,GK,Manchester City,26,1993,36.0,3,1,3,0,0,3,4,75.0,1,0,0,0,0,3,11,4,Matches
139,Kyle Edwards,eng ENG,"MF,FW",West Brom,22,1998,1.3,3,2,1,1,1,0,0,,0,2,0,2,1,4,0,0,Matches
140,John Egan,ie IRL,DF,Sheffield Utd,27,1992,29.2,41,21,29,12,0,22,39,56.4,17,43,31,12,41,82,131,0,Matches
141,Anthony Elanga,se SWE,FW,Manchester Utd,18,2002,1.7,4,2,3,1,0,4,5,80.0,1,1,1,0,1,5,1,0,Matches
142,Ahmed Elmohamady,eg EGY,DF,Aston Villa,32,1987,9.3,17,13,12,4,1,9,14,64.3,5,6,3,3,17,34,26,0,Matches
143,Mohamed Elneny,eg EGY,MF,Arsenal,28,1992,17.2,14,6,7,7,0,7,28,25.0,21,11,4,7,24,38,20,2,Matches
144,Jonny Evans,nir NIR,DF,Leicester City,32,1988,27.5,25,12,22,2,1,14,20,70.0,6,8,3,5,46,71,98,1,Matches
145,Eberechi Eze,eng ENG,MF,Crystal Palace,22,1998,28.4,27,14,11,13,3,16,35,45.7,19,19,3,16,24,51,9,1,Matches
146,Łukasz Fabiański,pl POL,GK,West Ham,35,1985,35.0,1,0,1,0,0,1,1,100.0,0,1,0,1,1,2,12,3,Matches
147,Fabinho,br BRA,"DF,MF",Liverpool,26,1993,28.5,58,31,21,29,8,27,54,50.0,27,28,10,18,44,102,66,1,Matches
148,Bruno Fernandes,pt POR,MF,Manchester Utd,25,1994,34.4,57,30,16,29,12,26,100,26.0,74,38,0,38,26,83,29,0,Matches
149,Federico Fernández,ar ARG,DF,Newcastle Utd,31,1989,23.1,29,22,23,5,1,17,21,81.0,4,41,31,10,17,46,147,0,Matches
150,Fernandinho,br BRA,MF,Manchester City,35,1985,13.2,31,17,8,14,9,20,43,46.5,23,11,2,9,23,54,17,0,Matches
151,Sam Field,eng ENG,MF,West Brom,22,1998,0.7,5,5,3,2,0,0,0,,0,4,1,3,2,7,4,0,Matches
152,Roberto Firmino,br BRA,FW,Liverpool,28,1991,31.5,33,15,3,17,13,6,32,18.8,26,42,5,37,11,44,12,0,Matches
153,Will Fish,eng ENG,FW,Manchester Utd,17,2003,0.0,0,0,0,0,0,0,0,,0,0,0,0,0,0,0,0,Matches
154,John Fleck,sct SCO,MF,Sheffield Utd,28,1991,28.6,51,33,28,18,5,26,83,31.3,57,26,4,22,28,79,12,1,Matches
155,Phil Foden,eng ENG,"FW,MF",Manchester City,20,2000,18.0,22,11,12,8,2,9,23,39.1,14,9,0,9,11,33,11,0,Matches
156,Wesley Fofana,fr FRA,DF,Leicester City,19,2000,25.1,51,37,27,22,2,31,46,67.4,15,28,16,12,61,112,94,0,Matches
157,Pablo Fornals,es ESP,"FW,MF",West Ham,24,1996,28.6,44,26,14,24,6,11,73,15.1,62,43,1,42,36,80,9,0,Matches
158,Fraser Forster,eng ENG,GK,Southampton,32,1988,8.0,1,0,1,0,0,1,2,50.0,1,0,0,0,0,1,9,0,Matches
159,Timothy Fosu-Mensah,nl NED,DF,Manchester Utd,22,1998,0.9,2,0,1,1,0,1,1,100.0,0,0,0,0,3,5,1,0,Matches
160,Tyrese Francois,au AUS,DF,Fulham,20,2000,0.2,0,0,0,0,0,0,0,,0,0,0,0,0,0,0,0,Matches
161,Ryan Fraser,sct SCO,"FW,MF",Newcastle Utd,26,1994,10.3,4,1,3,1,0,2,5,40.0,3,1,0,1,6,10,7,0,Matches
162,Fred,br BRA,MF,Manchester Utd,27,1993,26.6,81,39,39,38,4,29,89,32.6,60,49,9,40,45,126,26,1,Matches
163,Ryan Fredericks,eng ENG,"DF,FW",West Ham,27,1992,6.3,9,5,5,4,0,3,7,42.9,4,6,2,4,11,20,20,0,Matches
164,Christian Fuchs,at AUT,DF,Leicester City,34,1986,7.8,18,7,15,2,1,8,15,53.3,7,6,4,2,16,34,34,1,Matches
165,Darnell Furlong,eng ENG,DF,West Brom,24,1995,32.6,45,27,27,12,6,21,44,47.7,23,39,16,23,49,94,90,0,Matches
166,Conor Gallagher,eng ENG,MF,West Brom,20,2000,28.1,81,41,30,39,12,29,97,29.9,68,47,8,39,27,108,31,0,Matches
167,Eric García,es ESP,DF,Manchester City,19,2001,4.3,8,7,5,3,0,5,7,71.4,2,4,1,3,4,12,10,0,Matches
168,Dwight Gayle,eng ENG,"FW,MF",Newcastle Utd,29,1990,5.7,2,0,1,1,0,0,7,0.0,7,3,1,2,1,3,2,0,Matches
169,Jean-Philippe Gbamin,ci CIV,MF,Everton,24,1995,0.1,1,0,0,1,0,0,0,,0,1,0,1,0,1,1,0,Matches
170,David de Gea,es ESP,GK,Manchester Utd,29,1990,25.5,0,0,0,0,0,0,0,,0,0,0,0,0,0,8,3,Matches
171,Anwar El Ghazi,nl NED,FW,Aston Villa,25,1995,17.9,16,13,6,7,3,7,23,30.4,16,11,0,11,6,22,11,0,Matches
172,Kieran Gibbs,eng ENG,DF,West Brom,30,1989,9.0,15,11,11,3,1,8,10,80.0,2,8,6,2,16,31,30,1,Matches
173,Morgan Gibbs-White,eng ENG,"MF,FW",Wolves,20,2000,4.6,9,7,3,4,2,5,12,41.7,7,6,0,6,3,12,1,0,Matches
174,Billy Gilmour,sct SCO,MF,Chelsea,19,2001,2.9,4,2,1,2,1,2,7,28.6,5,3,2,1,3,7,1,0,Matches
175,Olivier Giroud,fr FRA,FW,Chelsea,33,1986,8.3,4,2,0,1,3,1,7,14.3,6,4,1,3,5,9,10,0,Matches
176,Ben Godfrey,eng ENG,DF,Everton,22,1998,29.8,55,33,37,15,3,27,41,65.9,14,56,37,19,33,88,120,0,Matches
177,André Gomes,pt POR,MF,Everton,27,1993,17.4,35,23,16,16,3,17,58,29.3,41,19,1,18,10,45,12,1,Matches
178,Joe Gomez,eng ENG,DF,Liverpool,23,1997,6.6,3,2,1,1,1,0,4,0.0,4,3,2,1,4,7,29,0,Matches
179,Anthony Gordon,eng ENG,"FW,MF",Everton,19,2001,1.0,3,3,3,0,0,0,2,0.0,2,1,0,1,1,4,3,0,Matches
180,Karlan Grant,eng ENG,"FW,MF",West Brom,22,1997,12.5,5,3,3,2,0,2,4,50.0,2,7,0,7,5,10,17,0,Matches
181,Demarai Gray,jm JAM,FW,Leicester City,24,1996,0.2,1,1,1,0,0,0,0,,0,0,0,0,0,1,0,0,Matches
182,Jack Grealish,eng ENG,"FW,MF",Aston Villa,24,1995,24.3,31,14,8,16,7,15,24,62.5,9,20,3,17,12,43,5,3,Matches
183,Mason Greenwood,eng ENG,FW,Manchester Utd,18,2001,20.2,13,10,6,4,3,5,22,22.7,17,9,0,9,5,18,1,0,Matches
184,Pascal Groß,de GER,"MF,DF",Brighton,29,1991,27.6,45,24,24,15,6,24,53,45.3,29,25,4,21,23,68,18,1,Matches
185,Kamil Grosicki,pl POL,"MF,FW",West Brom,32,1988,1.6,2,1,2,0,0,2,8,25.0,6,1,0,1,2,4,1,0,Matches
186,Vicente Guaita,es ESP,GK,Crystal Palace,33,1987,37.0,1,1,1,0,0,1,1,100.0,0,0,0,0,1,2,11,1,Matches
187,İlkay Gündoğan,de GER,MF,Manchester City,29,1990,22.5,25,15,8,12,5,10,39,25.6,29,13,4,9,20,45,9,0,Matches
188,Antwoine Hackford,eng ENG,DF,Sheffield Utd,16,2004,0.1,0,0,0,0,0,0,0,,0,0,0,0,0,0,0,0,Matches
189,Sébastien Haller,ci CIV,FW,West Ham,26,1994,10.4,14,9,1,6,7,4,20,20.0,16,7,1,6,5,19,7,0,Matches
190,Rekeem Harper,eng ENG,MF,West Brom,20,2000,0.4,0,0,0,0,0,0,0,,0,2,0,2,1,1,0,0,Matches
191,Jack Harrison,eng ENG,"MF,FW",Leeds United,23,1996,31.6,63,38,20,30,13,26,59,44.1,33,30,2,28,15,78,21,0,Matches
192,Kortney Hause,eng ENG,DF,Aston Villa,25,1995,7.0,4,2,3,1,0,0,3,0.0,3,4,2,2,8,12,53,0,Matches
193,Kai Havertz,de GER,"MF,FW",Chelsea,21,1999,16.9,18,9,6,10,2,6,27,22.2,21,25,0,25,4,22,22,1,Matches
194,Isaac Hayden,eng ENG,"MF,DF",Newcastle Utd,25,1995,21.6,52,29,23,22,7,14,35,40.0,21,32,9,23,43,95,47,0,Matches
195,Michael Hector,jm JAM,DF,Fulham,28,1992,2.9,3,2,1,2,0,1,6,16.7,5,4,2,2,0,3,6,0,Matches
196,Ahmed Hegazi,eg EGY,DF,West Brom,29,1991,1.0,0,0,0,0,0,0,0,,0,2,0,2,1,1,7,0,Matches
197,Dean Henderson,eng ENG,GK,Manchester Utd,23,1997,12.5,1,1,1,0,0,1,2,50.0,1,0,0,0,0,1,3,2,Matches
198,Jordan Henderson,eng ENG,"MF,DF",Liverpool,30,1990,18.9,24,15,12,9,3,10,26,38.5,16,12,1,11,34,58,30,0,Matches
199,Jeff Hendrick,ie IRL,MF,Newcastle Utd,28,1992,15.8,8,3,5,3,0,1,13,7.7,12,14,9,5,19,27,18,0,Matches
200,Pablo Hernández,es ESP,MF,Leeds United,35,1985,4.7,5,3,2,1,2,5,16,31.3,11,2,0,2,0,5,0,1,Matches
201,Son Heung-min,kr KOR,FW,Tottenham,28,1992,34.6,32,18,11,14,7,18,72,25.0,54,28,3,25,14,46,8,0,Matches
202,Ki-Jana Hoever,nl NED,"DF,MF",Wolves,18,2002,6.4,14,6,11,2,1,10,22,45.5,12,2,0,2,9,23,23,0,Matches
203,Rob Holding,eng ENG,DF,Arsenal,24,1995,28.4,43,20,28,13,2,17,35,48.6,18,37,27,10,24,67,120,0,Matches
204,Mason Holgate,eng ENG,DF,Everton,23,1996,25.4,56,36,31,18,7,20,50,40.0,30,37,13,24,35,91,90,3,Matches
205,Conor Hourihane,ie IRL,MF,Aston Villa,29,1991,2.5,0,0,0,0,0,0,2,0.0,2,3,0,3,0,0,2,0,Matches
206,Callum Hudson-Odoi,eng ENG,"FW,DF",Chelsea,19,2000,11.8,23,15,11,7,5,8,21,38.1,13,15,1,14,6,29,6,0,Matches
207,Niall Huggins,wls WAL,DF,Leeds United,19,2000,0.4,0,0,0,0,0,0,1,0.0,1,0,0,0,0,0,1,0,Matches
208,Pierre Højbjerg,dk DEN,MF,Tottenham,24,1995,38.0,98,51,45,42,11,54,129,41.9,75,51,9,42,48,146,66,0,Matches
209,Odion Ighalo,ng NGA,FW,Manchester Utd,31,1989,0.1,0,0,0,0,0,0,1,0.0,1,0,0,0,0,0,0,0,Matches
210,Kelechi Iheanacho,ng NGA,FW,Leicester City,23,1996,16.2,12,5,2,4,6,4,17,23.5,13,14,0,14,2,14,1,1,Matches
211,Danny Ings,eng ENG,FW,Southampton,28,1992,24.1,22,13,3,16,3,12,28,42.9,16,39,2,37,3,25,27,1,Matches
212,Branislav Ivanović,rs SRB,DF,West Brom,36,1984,8.5,14,5,11,3,0,7,13,53.8,6,11,5,6,8,22,25,0,Matches
213,Alex Iwobi,ng NGA,"FW,MF",Everton,24,1996,17.1,27,10,10,14,3,13,25,52.0,12,20,1,19,16,43,14,0,Matches
214,José Izquierdo,co COL,DF,Brighton,28,1992,0.1,0,0,0,0,0,0,0,,0,0,0,0,0,0,0,0,Matches
215,Phil Jagielka,eng ENG,DF,Sheffield Utd,37,1982,5.8,5,4,4,0,1,2,7,28.6,5,11,5,6,10,15,26,2,Matches
216,Alireza Jahanbakhsh,ir IRN,"FW,MF",Brighton,26,1993,5.9,9,7,3,5,1,2,12,16.7,10,8,0,8,8,17,1,0,Matches
217,Daniel James,wls WAL,FW,Manchester Utd,22,1997,10.1,15,9,4,7,4,3,18,16.7,15,10,1,9,0,15,6,0,Matches
218,Reece James,eng ENG,DF,Chelsea,20,1999,26.4,55,35,24,22,9,21,44,47.7,23,36,7,29,17,72,52,0,Matches
219,Alexandre Jankewitz,ch SUI,MF,Southampton,18,2001,0.0,2,1,2,0,0,1,1,100.0,0,0,0,0,0,2,0,0,Matches
220,Daniel Jebbison,eng ENG,FW,Sheffield Utd,16,2003,3.2,6,2,1,3,2,3,7,42.9,4,6,1,5,1,7,0,0,Matches
221,Gabriel Jesus,br BRA,FW,Manchester City,23,1997,22.9,17,6,5,5,7,11,28,39.3,17,16,0,16,15,32,5,0,Matches
222,Raúl Jiménez,mx MEX,FW,Wolves,29,1991,9.1,3,2,1,2,0,0,7,0.0,7,2,0,2,8,11,12,0,Matches
223,Joelinton,br BRA,"FW,MF",Newcastle Utd,23,1996,22.0,33,21,7,21,5,14,37,37.8,23,30,2,28,9,42,24,0,Matches
224,Ben Johnson,eng ENG,"DF,FW",West Ham,20,2000,5.8,11,5,5,3,3,7,9,77.8,2,5,1,4,11,22,9,0,Matches
225,Sam Johnstone,eng ENG,GK,West Brom,27,1993,37.0,0,0,0,0,0,0,0,,0,0,0,0,2,2,15,2,Matches
226,Curtis Jones,eng ENG,MF,Liverpool,19,2001,13.1,16,6,6,7,3,12,25,48.0,13,13,0,13,19,35,11,1,Matches
227,Jorginho,it ITA,MF,Chelsea,28,1991,22.3,57,30,22,31,4,31,76,40.8,45,33,5,28,40,97,21,3,Matches
228,Willian José,br BRA,FW,Wolves,28,1991,12.3,2,1,1,1,0,1,4,25.0,3,6,1,5,1,3,12,0,Matches
229,Diogo Jota,pt POR,FW,Liverpool,23,1996,12.4,12,6,4,7,1,2,29,6.9,27,9,0,9,5,17,3,0,Matches
230,James Justin,eng ENG,DF,Leicester City,22,1998,23.0,61,37,38,18,5,20,41,48.8,21,36,10,26,30,91,58,1,Matches
231,Ozan Kabak,tr TUR,DF,Liverpool,20,2000,8.9,19,10,11,4,4,6,9,66.7,3,2,2,0,12,31,28,1,Matches
232,Aboubakar Kamara,mr MTN,"FW,MF",Fulham,25,1995,3.5,2,2,1,1,0,0,5,0.0,5,6,0,6,1,3,0,0,Matches
233,Harry Kane,eng ENG,FW,Tottenham,27,1993,34.2,22,12,1,17,4,8,26,30.8,18,28,11,17,11,33,40,0,Matches
234,N'Golo Kanté,fr FRA,MF,Chelsea,29,1991,23.8,79,42,39,35,5,27,56,48.2,29,42,4,38,59,138,34,0,Matches
235,Moise Kean,it ITA,"FW,MF",Everton,20,2000,0.2,0,0,0,0,0,0,0,,0,0,0,0,0,0,0,0,Matches
236,Michael Keane,eng ENG,DF,Everton,27,1993,33.2,28,15,20,8,0,14,31,45.2,17,46,33,13,51,79,161,0,Matches
237,Neeskens Kebano,cd COD,"FW,MF",Fulham,28,1992,1.3,0,0,0,0,0,0,1,0.0,1,3,0,3,0,0,0,0,Matches
238,Naby Keïta,gn GUI,MF,Liverpool,25,1995,5.8,11,5,1,8,2,7,17,41.2,10,10,0,10,9,20,6,0,Matches
239,Caoimhín Kelleher,ie IRL,GK,Liverpool,21,1998,2.0,0,0,0,0,0,0,0,,0,0,0,0,0,0,2,0,Matches
240,Martin Kelly,eng ENG,DF,Crystal Palace,30,1990,0.0,1,0,1,0,0,1,1,100.0,0,0,0,0,0,1,0,0,Matches
241,Jonjoe Kenny,eng ENG,DF,Everton,23,1997,0.9,2,1,1,0,1,2,2,100.0,0,0,0,0,1,3,3,0,Matches
242,Reda Khadra,de GER,MF,Brighton,19,2001,0.1,0,0,0,0,0,0,0,,0,0,0,0,0,0,0,0,Matches
243,Max Kilman,eng ENG,DF,Wolves,23,1997,14.6,21,14,13,4,4,8,14,57.1,6,17,8,9,19,40,46,0,Matches
244,Joshua King,no NOR,"MF,FW",Everton,28,1992,1.6,4,1,2,1,1,0,0,,0,3,0,3,1,5,1,0,Matches
245,Mateusz Klich,pl POL,MF,Leeds United,30,1990,26.6,38,20,14,20,4,14,61,23.0,47,13,4,9,11,49,16,0,Matches
246,Robin Koch,de GER,"DF,MF",Leeds United,24,1996,12.6,27,16,17,10,0,10,19,52.6,9,18,12,6,27,54,34,2,Matches
247,Sead Kolašinac,ba BIH,DF,Arsenal,27,1993,1.0,0,0,0,0,0,0,0,,0,0,0,0,1,1,0,0,Matches
248,Terence Kongolo,nl NED,DF,Fulham,26,1994,1.0,3,2,1,2,0,1,1,100.0,0,0,0,0,2,5,3,0,Matches
249,Ezri Konsa,eng ENG,DF,Aston Villa,22,1997,35.5,25,13,18,6,1,9,13,69.2,4,53,47,6,29,54,162,1,Matches
250,Cheikhou Kouyaté,sn SEN,DF,Crystal Palace,30,1989,34.7,58,37,44,12,2,25,43,58.1,18,42,26,16,32,90,125,2,Matches
251,Mateo Kovačić,hr CRO,MF,Chelsea,26,1994,20.2,46,28,19,24,3,17,32,53.1,15,18,1,17,15,61,11,2,Matches
252,Emil Krafth,se SWE,DF,Newcastle Utd,25,1994,14.3,19,8,9,9,1,12,25,48.0,13,15,9,6,15,34,52,2,Matches
253,Filip Krovinović,hr CRO,MF,West Brom,24,1995,6.1,13,10,6,5,2,6,18,33.3,12,2,0,2,4,17,2,0,Matches
254,Alexandre Lacazette,fr FRA,FW,Arsenal,29,1991,21.4,18,10,4,11,3,4,22,18.2,18,20,1,19,12,30,13,0,Matches
255,Adam Lallana,eng ENG,"MF,FW",Brighton,32,1988,17.7,28,13,11,13,4,8,39,20.5,31,18,3,15,15,43,13,0,Matches
256,Érik Lamela,ar ARG,"FW,MF",Tottenham,28,1992,8.0,17,9,1,11,5,8,21,38.1,13,11,1,10,6,23,2,0,Matches
257,Tariq Lamptey,gh GHA,"DF,MF",Brighton,19,2000,9.8,17,9,7,6,4,6,13,46.2,7,8,1,7,19,36,12,1,Matches
258,Manuel Lanzini,ar ARG,"MF,FW",West Ham,27,1993,6.3,9,2,3,4,2,3,10,30.0,7,9,0,9,7,16,5,0,Matches
259,Aymeric Laporte,es ESP,DF,Manchester City,26,1994,14.9,13,6,10,3,0,7,11,63.6,4,12,7,5,11,24,28,0,Matches
260,Jamaal Lascelles,eng ENG,DF,Newcastle Utd,26,1993,18.1,14,7,5,9,0,3,6,50.0,3,27,17,10,12,26,86,0,Matches
261,Maxime Le Marchand,fr FRA,DF,Fulham,30,1989,1.4,2,2,2,0,0,2,2,100.0,0,0,0,0,0,2,3,0,Matches
262,Mario Lemina,ga GAB,MF,Fulham,26,1993,18.9,62,35,25,30,7,23,44,52.3,21,26,5,21,30,92,21,0,Matches
263,Bernd Leno,de GER,GK,Arsenal,28,1992,34.8,1,0,1,0,0,1,1,100.0,0,1,0,1,0,1,11,2,Matches
264,Khanya Leshabela,za RSA,MF,Leicester City,20,1999,0.1,0,0,0,0,0,0,0,,0,0,0,0,0,0,0,0,Matches
265,Jamal Lewis,nir NIR,DF,Newcastle Utd,22,1998,20.4,37,20,23,13,1,16,38,42.1,22,21,7,14,11,48,44,1,Matches
266,Victor Lindelöf,se SWE,DF,Manchester Utd,26,1994,28.7,22,10,12,10,0,12,24,50.0,12,22,14,8,30,52,95,1,Matches
267,Jesse Lingard,eng ENG,"MF,FW",West Ham,27,1992,15.8,12,6,4,8,0,5,14,35.7,9,7,1,6,4,16,0,0,Matches
268,Jake Livermore,eng ENG,MF,West Brom,30,1989,13.8,33,18,14,16,3,14,31,45.2,17,21,6,15,16,49,26,0,Matches
269,Diego Llorente,es ESP,DF,Leeds United,26,1993,13.4,34,21,21,13,0,19,32,59.4,13,18,13,5,20,54,40,2,Matches
270,Hugo Lloris,fr FRA,GK,Tottenham,33,1986,38.0,0,0,0,0,0,0,1,0.0,1,0,0,0,0,0,10,1,Matches
271,Giovani Lo Celso,ar ARG,MF,Tottenham,24,1996,10.5,28,22,12,11,5,10,29,34.5,19,12,1,11,7,35,5,0,Matches
272,Ruben Loftus-Cheek,eng ENG,FW,Chelsea,24,1996,0.7,0,0,0,0,0,0,0,,0,0,0,0,0,0,0,0,Matches
273,Ruben Loftus-Cheek,eng ENG,"MF,FW",Fulham,24,1996,21.2,25,14,7,15,3,7,23,30.4,16,20,2,18,7,32,18,0,Matches
274,Kevin Long,ie IRL,DF,Burnley,29,1990,7.1,11,6,9,2,0,7,9,77.8,2,11,7,4,6,17,24,0,Matches
275,Shane Long,ie IRL,FW,Southampton,33,1987,2.3,2,1,0,0,2,2,3,66.7,1,0,0,0,3,5,1,0,Matches
276,Matthew Longstaff,eng ENG,MF,Newcastle Utd,20,2000,4.2,3,2,2,1,0,2,8,25.0,6,7,0,7,7,10,2,0,Matches
277,Sean Longstaff,eng ENG,MF,Newcastle Utd,22,1997,15.7,31,14,13,15,3,18,42,42.9,24,26,5,21,19,50,14,2,Matches
278,Ademola Lookman,ng NGA,"FW,MF",Fulham,22,1997,30.5,35,11,18,9,8,13,44,29.5,31,31,1,30,20,55,9,0,Matches
279,Max Lowe,eng ENG,DF,Sheffield Utd,23,1997,6.1,26,11,18,6,2,9,21,42.9,12,12,4,8,5,31,11,0,Matches
280,Matthew Lowton,eng ENG,DF,Burnley,31,1989,34.0,54,32,31,22,1,32,73,43.8,41,36,13,23,56,110,91,1,Matches
281,David Luiz,br BRA,DF,Arsenal,33,1987,15.5,12,9,5,7,0,4,4,100.0,0,16,9,7,16,28,50,2,Matches
282,Douglas Luiz,br BRA,MF,Aston Villa,22,1998,30.9,49,18,22,26,1,20,58,34.5,38,52,17,35,43,92,44,2,Matches
283,John Lundstram,eng ENG,MF,Sheffield Utd,26,1994,22.6,25,16,12,11,2,13,47,27.7,34,26,8,18,14,39,29,1,Matches
284,Alexis Mac Allister,ar ARG,"MF,FW",Brighton,21,1998,12.4,26,12,6,16,4,11,38,28.9,27,25,4,21,9,35,4,0,Matches
285,James Maddison,eng ENG,MF,Leicester City,23,1996,23.3,32,16,5,16,11,14,41,34.1,27,14,1,13,9,41,5,0,Matches
286,Gabriel Magalhães,br BRA,DF,Arsenal,22,1997,22.2,25,15,19,5,1,13,19,68.4,6,27,19,8,26,51,74,2,Matches
287,Harry Maguire,eng ENG,DF,Manchester Utd,27,1993,33.9,29,17,19,10,0,18,29,62.1,11,28,23,5,60,89,122,4,Matches
288,Riyad Mahrez,dz ALG,FW,Manchester City,29,1991,21.7,20,5,2,10,8,6,30,20.0,24,19,0,19,8,28,4,0,Matches
289,Ainsley Maitland-Niles,eng ENG,"MF,DF",Arsenal,22,1997,5.4,11,7,6,5,0,8,12,66.7,4,12,2,10,14,25,7,1,Matches
290,Ainsley Maitland-Niles,eng ENG,MF,West Brom,22,1997,13.7,22,10,7,8,7,9,28,32.1,19,12,1,11,17,39,24,0,Matches
291,Josh Maja,ng NGA,FW,Fulham,21,1998,9.0,7,4,0,3,4,4,10,40.0,6,3,1,2,4,11,1,0,Matches
292,Sadio Mané,sn SEN,FW,Liverpool,28,1992,31.2,48,30,6,22,20,12,33,36.4,21,30,0,30,15,63,11,0,Matches
293,Javier Manquillo,es ESP,DF,Newcastle Utd,26,1994,9.2,24,14,8,14,2,11,17,64.7,6,8,1,7,9,33,15,1,Matches
294,Fernando Marçal,br BRA,"DF,MF",Wolves,31,1989,6.9,13,5,6,7,0,6,11,54.5,5,11,2,9,12,25,25,0,Matches
295,Solly March,eng ENG,"DF,MF",Brighton,26,1994,18.6,49,23,24,15,10,18,34,52.9,16,30,5,25,22,71,30,0,Matches
296,Pablo Marí,es ESP,DF,Arsenal,26,1993,10.0,15,9,12,3,0,5,10,50.0,5,8,7,1,9,24,30,2,Matches
297,Anthony Martial,fr FRA,FW,Manchester Utd,24,1995,16.4,2,1,1,1,0,0,10,0.0,10,17,3,14,1,3,8,0,Matches
298,Gabriel Martinelli,br BRA,FW,Arsenal,19,2001,6.5,7,1,2,3,2,4,10,40.0,6,6,0,6,8,15,4,0,Matches
299,Emiliano Martínez,ar ARG,GK,Aston Villa,27,1992,38.0,3,3,3,0,0,3,4,75.0,1,0,0,0,2,5,10,2,Matches
300,Arthur Masuaku,cd COD,"DF,MF",West Ham,26,1993,11.2,20,12,14,6,0,11,34,32.4,23,12,0,12,8,28,28,2,Matches
301,Juan Mata,es ESP,"FW,MF",Manchester Utd,32,1988,5.7,1,0,1,0,0,0,7,0.0,7,3,0,3,3,4,3,0,Matches
302,Jean-Philippe Mateta,fr FRA,FW,Crystal Palace,23,1997,2.5,1,1,0,1,0,1,3,33.3,2,1,0,1,0,1,2,0,Matches
303,Nemanja Matić,rs SRB,MF,Manchester Utd,31,1988,12.3,25,11,13,12,0,13,31,41.9,18,19,5,14,22,47,10,3,Matches
304,Joël Matip,cm CMR,DF,Liverpool,28,1991,7.7,14,9,7,7,0,7,8,87.5,1,6,0,6,7,21,22,0,Matches
305,Neal Maupay,fr FRA,"FW,MF",Brighton,23,1996,27.9,20,8,9,7,4,4,24,16.7,20,20,0,20,13,33,6,0,Matches
306,James McArthur,sct SCO,MF,Crystal Palace,32,1987,16.3,57,32,25,27,5,15,39,38.5,24,28,3,25,23,80,31,0,Matches
307,Oliver McBurnie,sct SCO,FW,Sheffield Utd,24,1996,14.7,15,7,7,7,1,5,17,29.4,12,10,3,7,6,21,30,0,Matches
308,Alex McCarthy,eng ENG,GK,Southampton,30,1989,30.0,1,0,1,0,0,1,4,25.0,3,0,0,0,0,1,11,1,Matches
309,James McCarthy,ie IRL,MF,Crystal Palace,29,1990,9.1,16,12,9,7,0,8,21,38.1,13,15,7,8,8,24,12,0,Matches
310,John McGinn,sct SCO,MF,Aston Villa,25,1994,37.0,61,37,23,31,7,27,84,32.1,57,38,6,32,43,104,23,2,Matches
311,David McGoldrick,ie IRL,"FW,MF",Sheffield Utd,32,1987,26.6,33,21,8,15,10,13,31,41.9,18,19,3,16,2,35,25,0,Matches
312,Dwight McNeil,eng ENG,MF,Burnley,20,1999,34.1,47,24,24,18,5,18,56,32.1,38,44,6,38,32,79,32,1,Matches
313,Scott McTominay,sct SCO,MF,Manchester Utd,23,1996,23.7,51,24,23,25,3,23,36,63.9,13,35,10,25,29,80,46,0,Matches
314,Ben Mee,eng ENG,DF,Burnley,30,1989,29.9,32,15,16,14,2,14,29,48.3,15,54,45,9,43,75,148,2,Matches
315,Hannibal Mejbri,tn TUN,MF,Manchester Utd,17,2003,0.1,0,0,0,0,0,0,0,,0,0,0,0,0,0,0,0,Matches
316,Benjamin Mendy,fr FRA,DF,Manchester City,26,1994,10.6,13,9,1,8,4,5,21,23.8,16,12,5,7,5,18,14,1,Matches
317,Edouard Mendy,sn SEN,GK,Chelsea,28,1992,30.5,0,0,0,0,0,0,1,0.0,1,0,0,0,1,1,9,3,Matches
318,Nampalys Mendy,sn SEN,MF,Leicester City,28,1992,16.2,26,17,18,6,2,7,20,35.0,13,12,1,11,14,40,8,0,Matches
319,Illan Meslier,fr FRA,GK,Leeds United,20,2000,35.0,0,0,0,0,0,0,1,0.0,1,0,0,0,0,0,17,8,Matches
320,Luka Milivojević,rs SRB,MF,Crystal Palace,29,1991,26.2,65,34,25,31,9,42,77,54.5,35,29,6,23,35,100,47,2,Matches
321,James Milner,eng ENG,"MF,DF",Liverpool,34,1986,11.9,26,19,9,14,3,11,33,33.3,22,30,3,27,14,40,16,1,Matches
322,Yerry Mina,co COL,DF,Everton,25,1994,21.5,21,14,17,4,0,8,12,66.7,4,30,23,7,24,45,110,1,Matches
323,Takumi Minamino,jp JPN,MF,Southampton,25,1995,7.9,7,3,2,5,0,2,19,10.5,17,13,1,12,4,11,9,0,Matches
324,Takumi Minamino,jp JPN,"MF,FW",Liverpool,25,1995,3.3,4,3,1,2,1,0,12,0.0,12,1,0,1,2,6,3,0,Matches
325,Tyrone Mings,eng ENG,DF,Aston Villa,27,1993,35.5,32,16,23,7,2,16,24,66.7,8,59,40,19,41,73,172,3,Matches
326,Tyrick Mitchell,eng ENG,DF,Crystal Palace,20,1999,19.0,64,35,48,9,7,23,40,57.5,17,29,10,19,21,85,62,1,Matches
327,Aleksandar Mitrović,rs SRB,FW,Fulham,25,1994,15.6,7,4,0,3,4,2,8,25.0,6,12,3,9,3,10,8,0,Matches
328,Jakub Moder,pl POL,"DF,MF",Brighton,21,1999,7.2,15,7,5,7,3,7,20,35.0,13,12,1,11,3,18,9,0,Matches
329,Jayson Molumby,ie IRL,MF,Brighton,20,1999,0.0,0,0,0,0,0,0,0,,0,0,0,0,0,0,0,0,Matches
330,Wesley Moraes,br BRA,FW,Aston Villa,23,1996,0.2,0,0,0,0,0,0,1,0.0,1,0,0,0,0,0,0,0,Matches
331,Wes Morgan,jm JAM,DF,Leicester City,36,1984,0.2,0,0,0,0,0,0,0,,0,0,0,0,0,0,1,0,Matches
332,Mason Mount,eng ENG,MF,Chelsea,21,1999,32.1,75,35,22,38,15,25,69,36.2,44,40,2,38,31,106,14,0,Matches
333,Lucas Moura,br BRA,"FW,MF",Tottenham,27,1992,15.7,32,16,12,16,4,8,29,27.6,21,12,0,12,18,50,10,0,Matches
334,Lys Mousset,fr FRA,"FW,MF",Sheffield Utd,24,1996,3.3,1,0,0,0,1,0,2,0.0,2,1,0,1,0,1,1,1,Matches
335,João Moutinho,pt POR,MF,Wolves,33,1986,28.1,75,40,34,35,6,35,91,38.5,56,18,3,15,47,122,28,0,Matches
336,Joel Mumbongo,se SWE,FW,Burnley,21,1999,0.4,0,0,0,0,0,0,0,,0,1,0,1,0,0,0,0,Matches
337,Jacob Murphy,eng ENG,"DF,MF",Newcastle Utd,25,1995,18.1,39,24,25,12,2,24,49,49.0,25,27,3,24,14,53,29,0,Matches
338,Shkodran Mustafi,de GER,DF,Arsenal,28,1992,0.5,1,1,1,0,0,1,1,100.0,0,1,0,1,0,1,3,0,Matches
339,Marvelous Nakamba,zw ZIM,MF,Aston Villa,26,1994,8.3,22,14,10,11,1,7,12,58.3,5,16,5,11,17,39,9,1,Matches
340,Iliman Ndiaye,sn SEN,MF,Sheffield Utd,20,2000,0.1,1,1,0,1,0,1,1,100.0,0,0,0,0,0,1,0,0,Matches
341,Wilfred Ndidi,ng NGA,"MF,DF",Leicester City,23,1996,24.2,96,63,45,44,7,26,66,39.4,40,38,11,27,61,157,55,0,Matches
342,Tanguy Ndombele,fr FRA,MF,Tottenham,23,1996,23.2,41,20,11,21,9,18,44,40.9,26,28,4,24,19,60,15,0,Matches
343,Reiss Nelson,eng ENG,"FW,MF",Arsenal,20,1999,0.8,1,0,0,0,1,0,0,,0,0,0,0,1,2,1,0,Matches
344,Pedro Neto,pt POR,"FW,MF",Wolves,20,2000,28.3,16,9,4,6,6,6,28,21.4,22,18,2,16,31,47,8,0,Matches
345,Rúben Neves,pt POR,MF,Wolves,23,1997,29.7,86,46,42,38,6,36,88,40.9,52,55,11,44,65,151,46,2,Matches
346,Eddie Nketiah,eng ENG,FW,Arsenal,21,1999,4.7,3,1,0,2,1,0,2,0.0,2,6,0,6,0,3,5,0,Matches
347,Niels Nkounkou,fr FRA,"DF,FW",Everton,19,2000,0.9,4,3,1,2,1,3,8,37.5,5,4,0,4,0,4,4,0,Matches
348,Dan Nlundulu,eng ENG,"FW,MF",Southampton,21,1999,1.2,0,0,0,0,0,0,1,0.0,1,2,0,2,0,0,2,0,Matches
349,Mark Noble,eng ENG,MF,West Ham,33,1987,7.9,8,4,2,5,1,4,14,28.6,10,7,3,4,13,21,3,0,Matches
350,Will Norris,eng ENG,GK,Burnley,26,1993,2.0,0,0,0,0,0,0,0,,0,0,0,0,0,0,0,0,Matches
351,Oliver Norwood,nir NIR,MF,Sheffield Utd,29,1991,24.7,49,22,16,28,5,21,72,29.2,51,29,12,17,36,85,51,1,Matches
352,Jack O'Connell,eng ENG,DF,Sheffield Utd,26,1994,2.0,3,1,1,1,1,0,1,0.0,1,4,3,1,2,5,7,0,Matches
353,Dara O'Shea,ie IRL,DF,West Brom,21,1999,23.4,45,25,30,13,2,21,45,46.7,24,32,17,15,45,90,108,0,Matches
354,Michael Obafemi,ie IRL,FW,Southampton,20,2000,0.7,1,0,0,1,0,0,1,0.0,1,1,0,1,0,1,0,0,Matches
355,Denis Odoi,gh GHA,DF,Fulham,32,1988,3.0,3,3,2,1,0,1,4,25.0,3,3,1,2,5,8,5,0,Matches
356,Angelo Ogbonna,it ITA,DF,West Ham,32,1988,27.7,26,13,20,5,1,9,17,52.9,8,25,11,14,30,56,119,0,Matches
357,Robin Olsen,se SWE,GK,Everton,30,1990,7.0,0,0,0,0,0,0,0,,0,0,0,0,0,0,4,1,Matches
358,Josh Onomah,eng ENG,MF,Fulham,23,1997,4.2,11,8,1,6,4,0,5,0.0,5,4,2,2,2,13,1,0,Matches
359,Divock Origi,be BEL,FW,Liverpool,25,1995,2.1,3,2,0,2,1,1,3,33.3,2,5,1,4,1,4,2,0,Matches
360,Ben Osborn,eng ENG,"MF,DF",Sheffield Utd,25,1994,17.8,33,18,15,10,8,13,40,32.5,27,20,3,17,12,45,17,0,Matches
361,Owen Otasowie,us USA,"MF,FW",Wolves,19,2001,2.1,5,5,3,2,0,1,2,50.0,1,1,1,0,3,8,4,0,Matches
362,Alex Oxlade-Chamberlain,eng ENG,"MF,FW",Liverpool,26,1993,2.8,4,0,0,3,1,0,2,0.0,2,1,0,1,2,6,0,0,Matches
363,Emerson Palmieri,it ITA,DF,Chelsea,25,1994,1.0,3,3,2,0,1,1,3,33.3,2,0,0,0,1,4,6,0,Matches
364,Thomas Partey,gh GHA,MF,Arsenal,27,1993,17.0,44,21,16,24,4,24,56,42.9,32,17,5,12,23,67,18,0,Matches
365,Rui Patrício,pt POR,GK,Wolves,32,1988,37.0,0,0,0,0,0,0,1,0.0,1,0,0,0,1,1,3,3,Matches
366,Bailey Peacock-Farrell,nir NIR,GK,Burnley,23,1996,4.0,0,0,0,0,0,0,0,,0,0,0,0,0,0,0,0,Matches
367,Lee Peltier,eng ENG,DF,West Brom,33,1986,2.5,9,4,8,1,0,4,4,100.0,0,1,1,0,1,10,11,0,Matches
368,Nicolas Pépé,ci CIV,FW,Arsenal,25,1995,18.0,20,15,8,6,6,8,23,34.8,15,16,1,15,12,32,19,0,Matches
369,Matheus Pereira,br BRA,"MF,FW",West Brom,24,1996,28.6,26,15,14,10,2,12,54,22.2,42,18,0,18,29,55,16,0,Matches
370,Ricardo Pereira,pt POR,"DF,FW",Leicester City,26,1993,10.7,31,22,16,8,7,14,35,40.0,21,24,1,23,15,46,23,0,Matches
371,Ayoze Pérez,es ESP,"MF,FW",Leicester City,27,1993,14.8,32,15,6,20,6,13,48,27.1,35,28,0,28,10,42,7,0,Matches
372,Kalvin Phillips,eng ENG,MF,Leeds United,24,1995,27.0,74,38,38,29,7,26,62,41.9,36,49,14,35,45,119,53,3,Matches
373,Matt Phillips,sct SCO,MF,West Brom,29,1991,20.3,15,8,4,11,0,7,23,30.4,16,32,4,28,10,25,32,1,Matches
374,Nathaniel Phillips,eng ENG,DF,Liverpool,23,1997,16.2,22,14,15,7,0,11,24,45.8,13,17,14,3,20,42,81,0,Matches
375,Jaden Philogene Bidace,eng ENG,FW,Aston Villa,18,2002,0.0,0,0,0,0,0,0,0,,0,0,0,0,0,0,0,0,Matches
376,Jordan Pickford,eng ENG,GK,Everton,26,1994,30.5,0,0,0,0,0,0,2,0.0,2,2,0,2,3,3,16,4,Matches
377,Erik Pieters,nl NED,"DF,MF",Burnley,31,1988,14.1,30,21,18,9,3,19,39,48.7,20,30,9,21,12,42,34,0,Matches
378,Daniel Podence,pt POR,"MF,FW",Wolves,24,1995,18.5,12,6,5,5,2,2,19,10.5,17,5,1,4,13,25,2,0,Matches
379,Paul Pogba,fr FRA,"MF,FW",Manchester Utd,27,1993,21.1,36,26,15,16,5,11,33,33.3,22,24,2,22,26,62,37,0,Matches
380,Nick Pope,eng ENG,GK,Burnley,28,1992,32.0,1,1,1,0,0,0,1,0.0,1,0,0,0,2,3,29,2,Matches
381,Ian Poveda,eng ENG,MF,Leeds United,20,2000,3.9,5,4,3,0,2,1,7,14.3,6,5,1,4,1,6,2,0,Matches
382,Dennis Praet,be BEL,MF,Leicester City,26,1994,8.0,14,7,4,7,3,6,15,40.0,9,12,2,10,7,21,3,0,Matches
383,Davy Pröpper,nl NED,MF,Brighton,28,1991,2.4,6,5,0,6,0,2,5,40.0,3,3,0,3,1,7,0,0,Matches
384,Christian Pulisic,us USA,"FW,MF",Chelsea,21,1998,19.3,19,11,8,10,1,8,21,38.1,13,25,2,23,12,31,9,0,Matches
385,Aaron Ramsdale,eng ENG,GK,Sheffield Utd,22,1998,38.0,1,1,1,0,0,1,1,100.0,0,0,0,0,2,3,22,6,Matches
386,Jacob Ramsey,eng ENG,MF,Aston Villa,19,2001,7.0,10,5,3,4,3,2,12,16.7,10,13,6,7,4,14,5,0,Matches
387,Kayne Ramsey,eng ENG,DF,Southampton,19,2000,1.0,5,2,4,1,0,3,3,100.0,0,0,0,0,0,5,3,0,Matches
388,Darren Randolph,ie IRL,GK,West Ham,33,1987,3.0,0,0,0,0,0,0,0,,0,0,0,0,0,0,1,0,Matches
389,Raphinha,br BRA,"MF,FW",Leeds United,23,1996,26.2,34,17,13,16,5,12,58,20.7,46,31,1,30,29,63,27,0,Matches
390,Marcus Rashford,eng ENG,FW,Manchester Utd,22,1997,32.4,18,9,2,8,8,7,27,25.9,20,22,2,20,8,26,10,0,Matches
391,Tim Ream,us USA,DF,Fulham,32,1987,7.0,12,5,9,3,0,8,11,72.7,3,8,5,3,6,18,26,1,Matches
392,Nathan Redmond,eng ENG,"MF,FW",Southampton,26,1994,19.3,30,17,14,12,4,8,24,33.3,16,24,2,22,11,41,9,0,Matches
393,Harrison Reed,eng ENG,MF,Fulham,25,1995,25.0,63,38,28,28,7,29,73,39.7,44,34,11,23,50,113,31,1,Matches
394,Sergio Reguilón,es ESP,DF,Tottenham,23,1996,24.9,47,25,30,13,4,23,48,47.9,25,39,7,32,32,79,50,1,Matches
395,Bobby Reid,jm JAM,"MF,FW",Fulham,27,1993,26.4,31,15,17,10,4,18,39,46.2,21,19,5,14,21,52,39,0,Matches
396,Declan Rice,eng ENG,MF,West Ham,21,1999,32.0,59,35,33,25,1,21,51,41.2,30,39,11,28,59,118,41,0,Matches
397,Lewis Richardson,eng ENG,"FW,MF",Burnley,17,2003,0.0,0,0,0,0,0,0,0,,0,0,0,0,0,0,0,0,Matches
398,Richarlison,br BRA,FW,Everton,23,1997,31.8,50,32,21,22,7,16,51,31.4,35,28,3,25,14,64,36,1,Matches
399,Jaïro Riedewald,nl NED,MF,Crystal Palace,23,1996,20.2,34,15,13,17,4,16,36,44.4,20,39,7,32,29,63,25,0,Matches
400,Matt Ritchie,sct SCO,"DF,MF",Newcastle Utd,30,1989,15.0,10,3,5,3,2,3,17,17.6,14,17,2,15,12,22,47,0,Matches
401,Tyler Roberts,wls WAL,"MF,FW",Leeds United,21,1999,14.9,15,13,1,11,3,5,22,22.7,17,17,2,15,9,24,12,0,Matches
402,Andrew Robertson,sct SCO,DF,Liverpool,26,1994,37.6,46,34,23,18,5,28,57,49.1,29,39,9,30,21,67,79,1,Matches
403,Antonee Robinson,us USA,DF,Fulham,22,1997,24.0,45,28,24,16,5,27,44,61.4,17,21,4,17,37,82,68,0,Matches
404,Callum Robinson,ie IRL,"FW,MF",West Brom,25,1995,17.3,7,5,5,1,1,3,19,15.8,16,9,0,9,7,14,8,0,Matches
405,Jack Robinson,eng ENG,DF,Sheffield Utd,26,1993,9.7,14,6,8,5,1,6,11,54.5,5,10,4,6,9,23,42,0,Matches
406,Hal Robson-Kanu,wls WAL,FW,West Brom,31,1989,6.2,2,1,1,0,1,0,1,0.0,1,2,0,2,2,4,7,0,Matches
407,Marek Rodák,sk SVK,GK,Fulham,23,1996,2.0,0,0,0,0,0,0,0,,0,0,0,0,0,0,0,0,Matches
408,Joe Rodon,wls WAL,DF,Tottenham,22,1997,8.1,14,9,11,2,1,3,4,75.0,1,10,8,2,21,35,36,2,Matches
409,Rodri,es ESP,MF,Manchester City,24,1996,30.5,72,40,24,40,8,33,66,50.0,33,23,9,14,36,108,54,3,Matches
410,Rodrigo,es ESP,"MF,FW",Leeds United,29,1991,14.3,14,7,8,3,3,4,22,18.2,18,7,0,7,5,19,16,0,Matches
411,James Rodríguez,co COL,"FW,MF",Everton,29,1991,19.6,28,17,8,15,5,11,46,23.9,35,17,0,17,15,43,3,0,Matches
412,Jay Rodriguez,eng ENG,FW,Burnley,31,1989,14.1,25,16,5,15,5,13,28,46.4,15,25,4,21,2,27,7,0,Matches
413,Oriol Romeu,es ESP,MF,Southampton,28,1991,19.6,69,35,25,39,5,26,68,38.2,42,28,7,21,30,99,18,0,Matches
414,John Ruddy,eng ENG,GK,Wolves,33,1986,1.0,0,0,0,0,0,0,0,,0,0,0,0,0,0,0,0,Matches
415,Antonio Rüdiger,de GER,DF,Chelsea,27,1993,19.0,31,23,16,14,1,12,15,80.0,3,17,10,7,18,49,51,0,Matches
416,Mathew Ryan,au AUS,GK,Arsenal,28,1992,3.0,0,0,0,0,0,0,0,,0,0,0,0,0,0,1,0,Matches
417,Mathew Ryan,au AUS,GK,Brighton,28,1992,11.0,1,0,1,0,0,0,0,,0,0,0,0,0,1,4,0,Matches
418,Allan Saint-Maximin,fr FRA,"FW,MF",Newcastle Utd,23,1997,17.3,16,9,6,9,1,4,9,44.4,5,10,0,10,4,20,2,0,Matches
419,Romain Saïss,ma MAR,DF,Wolves,30,1990,26.7,35,24,23,12,0,19,33,57.6,14,28,13,15,52,87,115,1,Matches
420,Bukayo Saka,eng ENG,"FW,MF",Arsenal,18,2001,28.4,25,16,10,13,2,11,40,27.5,29,21,2,19,25,50,24,0,Matches
421,Mamadou Sakho,fr FRA,DF,Crystal Palace,30,1990,3.1,3,2,1,2,0,3,3,100.0,0,3,2,1,3,6,11,0,Matches
422,Mohamed Salah,eg EGY,FW,Liverpool,28,1992,34.2,18,9,4,4,10,7,16,43.8,9,10,0,10,1,19,10,1,Matches
423,Mohammed Salisu,gh GHA,DF,Southampton,21,1999,9.4,38,21,20,16,2,25,34,73.5,9,22,5,17,17,55,30,0,Matches
424,Davinson Sánchez,co COL,DF,Tottenham,24,1996,16.5,40,20,31,9,0,21,32,65.6,11,18,13,5,14,54,85,2,Matches
425,Robert Sánchez,es ESP,GK,Brighton,22,1997,27.0,1,0,1,0,0,1,1,100.0,0,1,0,1,1,2,11,2,Matches
426,Morgan Sanson,fr FRA,MF,Aston Villa,25,1994,3.3,7,4,4,2,1,1,4,25.0,3,5,0,5,4,11,1,0,Matches
427,Romaine Sawyers,kn SKN,MF,West Brom,28,1991,16.5,30,18,16,12,2,14,43,32.6,29,20,4,16,18,48,12,3,Matches
428,Dane Scarlett,eng ENG,FW,Tottenham,16,2004,0.0,0,0,0,0,0,0,0,,0,0,0,0,0,0,0,0,Matches
429,Fabian Schär,ch SUI,DF,Newcastle Utd,28,1991,13.8,13,4,8,5,0,7,19,36.8,12,19,12,7,27,40,52,1,Matches
430,Jeffrey Schlupp,gh GHA,MF,Crystal Palace,27,1992,15.9,29,16,14,12,3,6,23,26.1,17,24,8,16,22,51,16,0,Matches
431,Kasper Schmeichel,dk DEN,GK,Leicester City,33,1986,38.0,0,0,0,0,0,0,0,,0,0,0,0,0,0,10,0,Matches
432,Nélson Semedo,pt POR,"DF,MF",Wolves,26,1993,33.1,85,48,53,23,9,42,72,58.3,30,30,10,20,41,126,78,2,Matches
433,Femi Seriki,eng ENG,MF,Sheffield Utd,18,2002,0.0,0,0,0,0,0,0,0,,0,0,0,0,0,0,0,0,Matches
434,Jamie Shackleton,eng ENG,"MF,DF",Leeds United,20,1999,5.1,10,6,6,4,0,4,11,36.4,7,3,1,2,9,19,3,0,Matches
435,Xherdan Shaqiri,ch SUI,"MF,FW",Liverpool,28,1991,6.2,7,4,3,1,3,2,7,28.6,5,4,0,4,2,9,0,0,Matches
436,Billy Sharp,eng ENG,FW,Sheffield Utd,34,1986,8.2,5,1,0,3,2,2,9,22.2,7,2,0,2,0,5,2,0,Matches
437,Luke Shaw,eng ENG,DF,Manchester Utd,25,1995,29.5,44,28,21,16,7,21,36,58.3,15,34,9,25,20,64,44,2,Matches
438,Jonjo Shelvey,eng ENG,MF,Newcastle Utd,28,1992,29.1,39,14,18,19,2,10,37,27.0,27,26,14,12,36,75,42,0,Matches
439,Shola Shoretire,eng ENG,FW,Manchester Utd,16,2004,0.1,0,0,0,0,0,0,0,,0,0,0,0,0,0,0,0,Matches
440,Gylfi Sigurðsson,is ISL,"MF,FW",Everton,30,1989,25.0,30,20,9,14,7,13,44,29.5,31,31,2,29,34,64,21,1,Matches
441,Bernardo Silva,pt POR,"MF,FW",Manchester City,25,1994,22.9,26,14,7,12,7,11,52,21.2,41,17,1,16,17,43,8,0,Matches
442,Fábio Silva,pt POR,FW,Wolves,18,2002,15.2,6,4,1,4,1,4,12,33.3,8,12,1,11,4,10,5,1,Matches
443,Thiago Silva,br BRA,DF,Chelsea,35,1984,21.5,20,12,11,8,1,14,21,66.7,7,21,13,8,33,53,86,1,Matches
444,Moussa Sissoko,fr FRA,MF,Tottenham,30,1989,17.6,22,16,19,3,0,8,20,40.0,12,11,4,7,23,45,25,0,Matches
445,Islam Slimani,dz ALG,FW,Leicester City,32,1988,0.2,0,0,0,0,0,0,0,,0,0,0,0,0,0,0,0,Matches
446,William Smallbone,ie IRL,MF,Southampton,20,2000,1.9,6,3,2,4,0,1,3,33.3,2,5,0,5,2,8,1,0,Matches
447,Emile Smith Rowe,eng ENG,"MF,FW",Arsenal,20,2000,16.0,14,7,5,5,4,6,17,35.3,11,15,1,14,10,24,12,0,Matches
448,Robert Snodgrass,sct SCO,"MF,FW",West Brom,32,1987,5.8,17,12,12,4,1,10,16,62.5,6,11,2,9,1,18,12,0,Matches
449,Robert Snodgrass,sct SCO,"FW,MF",West Ham,32,1987,0.1,0,0,0,0,0,0,0,,0,0,0,0,0,0,0,0,Matches
450,Cédric Soares,pt POR,DF,Arsenal,28,1991,8.3,12,8,6,4,2,6,21,28.6,15,6,1,5,8,20,16,1,Matches
451,Tomáš Souček,cz CZE,MF,West Ham,25,1995,38.0,78,41,37,36,5,28,77,36.4,49,43,18,25,62,140,107,0,Matches
452,Çağlar Söyüncü,tr TUR,DF,Leicester City,24,1996,20.2,27,17,13,14,0,17,30,56.7,13,12,9,3,28,55,80,1,Matches
453,Zack Steffen,us USA,GK,Manchester City,25,1995,1.0,0,0,0,0,0,0,0,,0,0,0,0,0,0,0,0,Matches
454,Dale Stephens,eng ENG,MF,Burnley,31,1989,2.9,11,6,2,7,2,3,6,50.0,3,3,0,3,8,19,2,0,Matches
455,Jack Stephens,eng ENG,DF,Southampton,26,1994,17.1,34,19,19,15,0,17,38,44.7,21,25,14,11,28,62,64,2,Matches
456,Raheem Sterling,eng ENG,FW,Manchester City,25,1994,28.2,21,10,5,12,4,5,12,41.7,7,15,0,15,15,36,4,0,Matches
457,Enda Stevens,ie IRL,DF,Sheffield Utd,30,1990,30.0,59,26,32,19,8,33,58,56.9,25,41,12,29,22,81,81,1,Matches
458,John Stones,eng ENG,DF,Manchester City,26,1994,21.5,21,10,13,5,3,9,14,64.3,5,23,15,8,18,39,56,1,Matches
459,Pascal Struijk,nl NED,"DF,MF",Leeds United,20,1999,23.1,49,30,28,19,2,17,28,60.7,11,35,21,14,47,96,92,0,Matches
460,Japhet Tanganga,eng ENG,DF,Tottenham,21,1999,5.4,5,4,3,2,0,1,3,33.3,2,6,5,1,3,8,15,0,Matches
461,Matt Targett,eng ENG,DF,Aston Villa,24,1995,37.8,83,39,52,20,11,56,88,63.6,32,40,14,26,55,138,102,1,Matches
462,James Tarkowski,eng ENG,DF,Burnley,27,1992,36.0,66,39,52,11,3,25,49,51.0,24,54,42,12,44,110,163,1,Matches
463,Percy Tau,za RSA,FW,Brighton,26,1994,1.1,1,1,1,0,0,0,2,0.0,2,1,0,1,0,1,1,0,Matches
464,Sidnei Tavares,pt POR,MF,Leicester City,18,2001,0.9,1,1,0,1,0,0,0,,0,1,1,0,0,1,0,0,Matches
465,Charlie Taylor,eng ENG,DF,Burnley,26,1993,27.0,48,28,30,15,3,25,46,54.3,21,36,19,17,29,77,87,2,Matches
466,Neil Taylor,wls WAL,DF,Aston Villa,31,1989,0.2,1,1,1,0,0,0,0,,0,1,0,1,0,1,0,0,Matches
467,Allan Tchaptchet,fr FRA,DF,Southampton,18,2001,0.1,0,0,0,0,0,0,0,,0,0,0,0,0,0,0,0,Matches
468,Nathan Tella,ng NGA,"FW,MF",Southampton,21,1999,8.3,8,5,1,4,3,6,15,40.0,9,13,0,13,3,11,2,0,Matches
469,Alex Telles,br BRA,DF,Manchester Utd,27,1992,7.7,14,7,10,3,1,8,17,47.1,9,7,2,5,16,30,20,0,Matches
470,Kenny Tete,nl NED,"DF,MF",Fulham,24,1995,16.5,48,30,27,16,5,10,18,55.6,8,14,5,9,27,75,49,0,Matches
471,Luke Thomas,eng ENG,DF,Leicester City,19,2001,10.8,23,14,11,5,7,14,21,66.7,7,15,2,13,17,40,21,0,Matches
472,Youri Tielemans,be BEL,MF,Leicester City,23,1997,37.3,86,45,32,38,16,45,108,41.7,63,35,8,27,46,132,20,1,Matches
473,Kieran Tierney,sct SCO,DF,Arsenal,23,1997,25.5,27,15,5,14,8,11,31,35.5,20,31,10,21,16,43,63,0,Matches
474,James Tomkins,eng ENG,DF,Crystal Palace,31,1989,6.1,4,2,4,0,0,3,4,75.0,1,4,3,1,4,8,45,0,Matches
475,Fikayo Tomori,eng ENG,DF,Chelsea,22,1997,0.5,2,1,2,0,0,0,0,,0,1,1,0,2,4,8,0,Matches
476,Ferrán Torres,es ESP,"FW,MF",Manchester City,20,2000,14.5,12,5,4,6,2,5,16,31.3,11,16,0,16,3,15,8,0,Matches
477,Cenk Tosun,tr TUR,FW,Everton,29,1991,0.5,0,0,0,0,0,0,1,0.0,1,0,0,0,0,0,0,0,Matches
478,Andros Townsend,eng ENG,"MF,FW",Crystal Palace,29,1991,25.1,78,41,45,20,13,30,79,38.0,49,48,2,46,41,119,19,0,Matches
479,Conor Townsend,eng ENG,DF,West Brom,27,1993,24.8,44,28,32,9,3,30,49,61.2,19,38,15,23,36,80,55,2,Matches
480,Adama Traoré,es ESP,"FW,MF",Wolves,24,1996,29.4,28,16,11,13,4,13,21,61.9,8,23,1,22,7,35,12,1,Matches
481,Bertrand Traoré,bf BFA,FW,Aston Villa,24,1995,25.7,26,10,8,10,8,10,34,29.4,24,23,1,22,15,41,14,1,Matches
482,Trézéguet,eg EGY,FW,Aston Villa,25,1994,13.0,33,18,14,15,4,13,45,28.9,32,13,1,12,19,52,17,0,Matches
483,Leandro Trossard,be BEL,"MF,FW",Brighton,25,1994,29.0,33,14,11,16,6,10,36,27.8,26,34,2,32,26,59,7,1,Matches
484,Kostas Tsimikas,gr GRE,"DF,FW",Liverpool,24,1996,0.1,0,0,0,0,0,0,0,,0,0,0,0,0,0,0,0,Matches
485,Axel Tuanzebe,cd COD,DF,Manchester Utd,22,1997,4.5,13,7,5,7,1,8,9,88.9,1,7,5,2,3,16,18,0,Matches
486,Cengiz Ünder,tr TUR,"FW,MF",Leicester City,23,1997,3.1,4,1,0,3,1,3,5,60.0,2,3,0,3,2,6,0,0,Matches
487,Yan Valery,tn TUN,"DF,MF",Southampton,21,1999,1.1,5,3,2,3,0,1,5,20.0,4,2,0,2,2,7,5,0,Matches
488,Virgil van Dijk,nl NED,DF,Liverpool,29,1991,4.1,3,2,1,2,0,0,0,,0,1,1,0,5,8,8,1,Matches
489,Jamie Vardy,eng ENG,FW,Leicester City,33,1987,31.6,18,12,1,8,9,2,15,13.3,13,14,5,9,4,22,32,0,Matches
490,Joël Veltman,nl NED,DF,Brighton,28,1992,25.3,67,33,34,25,8,29,57,50.9,28,24,5,19,33,100,64,0,Matches
491,Jannik Vestergaard,dk DEN,DF,Southampton,27,1992,28.6,50,31,31,15,4,35,52,67.3,17,29,16,13,42,92,122,0,Matches
492,Rúben Vinagre,pt POR,"MF,DF",Wolves,21,1999,1.9,7,5,5,2,0,3,4,75.0,1,3,0,3,2,9,4,0,Matches
493,Carlos Vinícius,br BRA,FW,Tottenham,25,1995,3.4,3,1,2,1,0,1,1,100.0,0,0,0,0,2,5,5,0,Matches
494,João Virgínia,pt POR,GK,Everton,20,1999,0.5,0,0,0,0,0,0,0,,0,0,0,0,0,0,0,0,Matches
495,Vitinha,pt POR,MF,Wolves,20,2000,5.8,7,3,2,5,0,3,8,37.5,5,3,0,3,3,10,1,0,Matches
496,Jake Vokins,eng ENG,DF,Southampton,20,2000,0.7,0,0,0,0,0,0,1,0.0,1,0,0,0,0,0,0,0,Matches
497,Matěj Vydra,cz CZE,FW,Burnley,28,1992,15.2,9,5,2,4,3,1,8,12.5,7,8,1,7,6,15,5,0,Matches
498,Theo Walcott,eng ENG,"MF,FW",Southampton,31,1989,18.0,23,11,8,9,6,11,32,34.4,21,16,0,16,14,37,5,0,Matches
499,Theo Walcott,eng ENG,FW,Everton,31,1989,0.1,0,0,0,0,0,0,0,,0,0,0,0,0,0,0,0,Matches
500,Kyle Walker,eng ENG,DF,Manchester City,30,1990,21.6,29,19,15,12,2,16,24,66.7,8,19,7,12,14,43,28,0,Matches
501,Kyle Walker-Peters,eng ENG,DF,Southampton,23,1997,29.4,83,53,56,25,2,34,57,59.6,23,41,10,31,38,121,66,2,Matches
502,Aaron Wan-Bissaka,eng ENG,DF,Manchester Utd,22,1997,34.0,88,54,53,29,6,32,45,71.1,13,65,17,48,62,150,84,2,Matches
503,Joel Ward,eng ENG,DF,Crystal Palace,30,1989,25.1,43,25,29,14,0,24,42,57.1,18,27,8,19,41,84,87,2,Matches
504,James Ward-Prowse,eng ENG,MF,Southampton,25,1994,38.0,75,49,30,41,4,29,70,41.4,41,36,4,32,42,117,60,0,Matches
505,Ollie Watkins,eng ENG,FW,Aston Villa,24,1995,37.0,29,17,5,16,8,10,33,30.3,23,21,2,19,7,36,24,0,Matches
506,Caleb Watts,au AUS,MF,Southampton,18,2002,0.4,2,1,2,0,0,1,2,50.0,1,0,0,0,0,2,0,0,Matches
507,Adam Webster,eng ENG,DF,Brighton,25,1995,28.8,29,16,15,10,4,12,25,48.0,13,29,16,13,47,76,92,3,Matches
508,Danny Welbeck,eng ENG,FW,Brighton,29,1990,17.2,12,6,2,6,4,7,19,36.8,12,17,0,17,7,19,13,0,Matches
509,Timo Werner,de GER,"FW,MF",Chelsea,24,1996,28.9,20,9,6,11,3,7,43,16.3,36,23,1,22,8,28,8,0,Matches
510,Ashley Westwood,eng ENG,MF,Burnley,30,1990,37.9,23,15,6,12,5,10,42,23.8,32,26,9,17,44,67,33,0,Matches
511,Ben White,eng ENG,"DF,MF",Brighton,22,1997,35.5,49,26,21,24,4,24,57,42.1,33,46,22,24,62,111,56,0,Matches
512,Georginio Wijnaldum,nl NED,MF,Liverpool,29,1990,32.7,23,7,6,14,3,7,31,22.6,24,18,3,15,26,49,18,1,Matches
513,Brandon Williams,eng ENG,DF,Manchester Utd,19,2000,2.1,0,0,0,0,0,0,1,0.0,1,1,0,1,1,1,7,0,Matches
514,Neco Williams,wls WAL,DF,Liverpool,19,2001,2.8,6,5,4,2,0,5,9,55.6,4,3,1,2,6,12,6,0,Matches
515,Rhys Williams,eng ENG,DF,Liverpool,19,2001,7.3,6,4,3,3,0,3,3,100.0,0,4,3,1,6,12,27,1,Matches
516,Willian,br BRA,FW,Arsenal,31,1988,15.6,13,7,6,6,1,6,16,37.5,10,13,0,13,8,21,8,0,Matches
517,Joe Willock,eng ENG,MF,Arsenal,20,1999,2.6,6,3,1,4,1,3,7,42.9,4,6,1,5,3,9,0,0,Matches
518,Joe Willock,eng ENG,MF,Newcastle Utd,20,1999,10.9,26,13,16,7,3,9,42,21.4,33,21,3,18,17,43,15,1,Matches
519,Callum Wilson,eng ENG,FW,Newcastle Utd,28,1992,23.2,12,5,1,6,5,2,12,16.7,10,10,3,7,7,19,14,0,Matches
520,Harry Winks,eng ENG,MF,Tottenham,24,1996,9.6,16,9,11,5,0,5,20,25.0,15,16,4,12,11,27,12,1,Matches
521,Chris Wood,nz NZL,FW,Burnley,28,1991,30.5,12,7,2,4,6,5,18,27.8,13,14,3,11,1,13,21,0,Matches
522,Granit Xhaka,ch SUI,"MF,DF",Arsenal,27,1992,28.0,50,26,18,17,15,30,58,51.7,28,23,7,16,24,74,38,3,Matches
523,Andriy Yarmolenko,ua UKR,"FW,MF",West Ham,30,1989,4.2,5,4,2,2,1,2,8,25.0,6,1,0,1,1,6,2,0,Matches
524,DeAndre Yedlin,us USA,DF,Newcastle Utd,27,1993,4.8,9,4,8,1,0,4,10,40.0,6,5,1,4,7,16,17,0,Matches
525,Okay Yokuşlu,tr TUR,MF,West Brom,26,1994,14.6,38,25,21,13,4,17,35,48.6,18,15,3,12,35,73,33,1,Matches
526,Wilfried Zaha,ci CIV,FW,Crystal Palace,27,1992,29.0,26,18,8,15,3,11,30,36.7,19,21,0,21,9,35,4,0,Matches
527,Andre-Frank Zambo Anguissa,cm CMR,MF,Fulham,24,1995,28.7,78,37,27,38,13,27,68,39.7,41,35,6,29,56,134,17,2,Matches
528,Andi Zeqiri,ch SUI,"FW,DF",Brighton,21,1999,1.9,3,2,0,2,1,1,2,50.0,1,1,0,1,0,3,2,0,Matches
529,Oleksandr Zinchenko,ua UKR,DF,Manchester City,23,1996,16.4,25,15,12,9,4,14,24,58.3,10,17,4,13,23,48,28,0,Matches
530,Hakim Ziyech,ma MAR,"MF,FW",Chelsea,27,1993,13.0,14,10,5,7,2,5,19,26.3,14,9,1,8,10,24,2,0,Matches
531,Kurt Zouma,fr FRA,DF,Chelsea,25,1994,22.5,16,10,8,6,2,4,8,50.0,4,13,9,4,28,44,93,0,Matches
532,Martin Ødegaard,no NOR,MF,Arsenal,21,1998,9.6,9,3,2,6,1,4,14,28.6,10,2,0,2,2,11,5,0,Matches
1,Patrick van Aanholt,nl NED,DF,Crystal Palace,28,1990,27.9,43,23,31,10,2,23,50,46.0,27,31,9,22,45,88,52,1,Matches
2,Max Aarons,eng ENG,DF,Norwich City,19,2000,36.0,48,30,33,9,6,18,36,50.0,18,46,29,17,37,85,97,1,Matches
3,Tammy Abraham,eng ENG,FW,Chelsea,21,1997,24.6,8,4,2,5,1,3,14,21.4,11,20,2,18,6,14,27,0,Matches
4,Che Adams,sct SCO,FW,Southampton,23,1996,12.3,6,4,1,5,0,1,4,25.0,3,9,1,8,2,8,10,0,Matches
5,Adrián,es ESP,GK,Liverpool,32,1987,9.7,1,1,1,0,0,1,1,100.0,0,0,0,0,0,1,8,3,Matches
6,Sergio Agüero,ar ARG,FW,Manchester City,31,1988,16.1,7,4,0,4,3,1,8,12.5,7,9,1,8,3,10,2,0,Matches
7,Albian Ajeti,ch SUI,FW,West Ham,22,1997,1.5,1,0,0,0,1,0,0,,0,0,0,0,0,1,0,0,Matches
8,Nathan Aké,nl NED,DF,Bournemouth,24,1995,27.8,31,21,23,8,0,14,23,60.9,9,40,29,11,36,67,152,0,Matches
9,Marc Albrighton,eng ENG,"MF,DF",Leicester City,29,1989,9.6,24,17,10,13,1,9,30,30.0,21,19,2,17,10,34,8,0,Matches
10,Toby Alderweireld,be BEL,DF,Tottenham,30,1989,32.9,40,29,24,13,3,11,24,45.8,13,48,32,16,31,71,172,2,Matches
11,Trent Alexander-Arnold,eng ENG,DF,Liverpool,20,1998,35.3,55,34,35,17,3,36,78,46.2,42,27,9,18,45,100,84,3,Matches
12,Alisson,br BRA,GK,Liverpool,26,1992,28.3,0,0,0,0,0,0,2,0.0,2,0,0,0,1,1,13,3,Matches
13,Dele Alli,eng ENG,"MF,FW",Tottenham,23,1996,20.5,34,16,11,20,3,13,37,35.1,24,35,3,32,17,51,17,2,Matches
14,Miguel Almirón,py PAR,"MF,FW",Newcastle Utd,25,1994,33.6,60,39,32,20,8,19,52,36.5,33,25,1,24,31,91,25,0,Matches
15,Marcos Alonso,es ESP,DF,Chelsea,28,1990,15.9,28,16,20,6,2,14,33,42.4,19,18,2,16,20,48,32,0,Matches
16,Steven Alzate,co COL,"MF,DF",Brighton,20,1998,13.2,33,19,20,11,2,17,27,63.0,10,18,3,15,14,47,13,0,Matches
17,Ibrahim Amadou,fr FRA,"DF,MF",Norwich City,26,1993,8.4,18,11,9,8,1,3,11,27.3,8,8,5,3,16,34,55,1,Matches
18,Felipe Anderson,br BRA,"MF,FW",West Ham,26,1993,16.6,46,32,20,21,5,11,47,23.4,36,19,1,18,22,68,11,0,Matches
19,Florin Andone,ro ROU,FW,Brighton,26,1993,0.8,1,1,0,1,0,1,1,100.0,0,1,1,0,0,1,1,0,Matches
20,Angeliño,es ESP,DF,Manchester City,22,1997,4.7,5,2,3,1,1,5,7,71.4,2,1,0,1,9,14,15,0,Matches
21,Faustino Anjorin,eng ENG,FW,Chelsea,17,2001,0.2,0,0,0,0,0,0,0,,0,1,0,1,0,0,0,0,Matches
22,Michail Antonio,jm JAM,FW,West Ham,29,1990,19.6,13,9,5,4,4,4,14,28.6,10,17,2,15,9,22,5,0,Matches
23,Stuart Armstrong,sct SCO,MF,Southampton,27,1992,19.1,32,19,19,11,2,9,38,23.7,29,22,4,18,11,43,23,1,Matches
24,Kepa Arrizabalaga,es ESP,GK,Chelsea,24,1994,33.0,1,1,1,0,0,1,2,50.0,1,0,0,0,1,2,7,2,Matches
25,Christian Atsu,gh GHA,"MF,FW",Newcastle Utd,27,1992,8.3,10,8,5,5,0,5,14,35.7,9,19,0,19,5,15,9,0,Matches
26,Pierre-Emerick Aubameyang,ga GAB,FW,Arsenal,30,1989,34.8,31,19,10,12,9,12,51,23.5,39,39,1,38,14,45,16,0,Matches
27,Serge Aurier,ci CIV,DF,Tottenham,26,1992,30.0,93,69,58,27,8,39,69,56.5,30,38,6,32,47,140,98,2,Matches
28,Jordan Ayew,gh GHA,FW,Crystal Palace,27,1991,35.0,48,30,10,22,16,17,49,34.7,32,29,4,25,15,63,21,0,Matches
29,César Azpilicueta,es ESP,DF,Chelsea,29,1989,35.9,86,56,40,32,14,35,69,50.7,34,56,21,35,67,153,94,0,Matches
30,Eric Bailly,ci CIV,DF,Manchester Utd,25,1994,1.7,0,0,0,0,0,0,1,0.0,1,3,3,0,4,4,7,1,Matches
31,Leighton Baines,eng ENG,DF,Everton,34,1984,4.5,10,6,6,2,2,8,10,80.0,2,5,2,3,5,15,14,0,Matches
32,Fabián Balbuena,py PAR,DF,West Ham,27,1991,13.1,17,12,13,3,1,9,25,36.0,16,15,5,10,26,43,75,3,Matches
33,George Baldock,gr GRE,DF,Sheffield Utd,26,1993,38.0,62,43,35,17,10,27,47,57.4,20,26,3,23,34,96,83,3,Matches
34,Phil Bardsley,sct SCO,DF,Burnley,34,1985,21.0,49,36,16,24,9,24,37,64.9,13,24,11,13,30,79,73,0,Matches
35,Ross Barkley,eng ENG,MF,Chelsea,25,1993,12.3,16,9,6,6,4,5,18,27.8,13,7,2,5,7,23,7,0,Matches
36,Ashley Barnes,eng ENG,FW,Burnley,29,1989,15.0,10,5,3,5,2,3,9,33.3,6,7,2,5,6,16,9,0,Matches
37,Harvey Barnes,eng ENG,"MF,FW",Leicester City,21,1997,23.1,16,11,7,7,2,5,23,21.7,18,13,3,10,8,24,6,1,Matches
38,Chris Basham,eng ENG,DF,Sheffield Utd,31,1988,36.0,85,48,58,20,7,48,81,59.3,33,38,15,23,77,162,173,1,Matches
39,Borja Bastón,es ESP,"MF,FW",Aston Villa,26,1992,0.2,1,0,0,1,0,0,2,0.0,2,1,0,1,0,1,0,1,Matches
40,Michy Batshuayi,be BEL,FW,Chelsea,25,1993,2.7,4,1,2,2,0,0,5,0.0,5,1,1,0,0,4,1,0,Matches
41,Jan Bednarek,pl POL,DF,Southampton,23,1996,34.0,65,38,41,18,6,31,61,50.8,30,44,23,21,77,142,198,4,Matches
42,Héctor Bellerín,es ESP,"DF,MF",Arsenal,24,1995,12.9,20,13,7,11,2,11,29,37.9,18,20,4,16,19,39,27,1,Matches
43,Ryan Bennett,eng ENG,DF,Wolves,29,1990,6.7,4,2,4,0,0,2,6,33.3,4,14,8,6,9,13,29,0,Matches
44,Ryan Bennett,eng ENG,DF,Leicester City,29,1990,3.7,5,4,3,2,0,4,6,66.7,2,3,1,2,7,12,8,0,Matches
45,Nabil Bentaleb,dz ALG,MF,Newcastle Utd,24,1994,8.3,23,13,14,9,0,7,25,28.0,18,9,2,7,19,42,9,1,Matches
46,Christian Benteke,be BEL,FW,Crystal Palace,28,1990,14.0,9,5,1,6,2,0,10,0.0,10,11,4,7,4,13,28,1,Matches
47,Jóhann Berg Guðmundsson,is ISL,MF,Burnley,28,1990,6.9,4,2,2,2,0,1,8,12.5,7,8,1,7,7,11,9,0,Matches
48,Sander Berge,no NOR,MF,Sheffield Utd,21,1998,10.5,22,15,3,14,5,5,10,50.0,5,15,1,14,10,32,16,0,Matches
49,Steven Bergwijn,nl NED,"FW,MF",Tottenham,21,1997,7.8,10,6,3,6,1,4,12,33.3,8,12,0,12,1,11,5,0,Matches
50,Bernard,br BRA,"MF,FW",Everton,26,1992,14.2,32,22,12,14,6,13,44,29.5,31,22,2,20,16,48,7,0,Matches
51,Bernardo,br BRA,"DF,MF",Brighton,24,1995,7.5,27,16,12,9,6,13,17,76.5,4,7,3,4,6,33,24,0,Matches
52,Ryan Bertrand,eng ENG,DF,Southampton,29,1989,30.5,47,29,22,15,10,26,58,44.8,32,27,12,15,37,84,31,1,Matches
53,Muhamed Bešić,ba BIH,MF,Sheffield Utd,26,1992,2.8,8,6,4,4,0,2,5,40.0,3,4,0,4,1,9,6,0,Matches
54,Philip Billing,dk DEN,MF,Bournemouth,23,1996,28.1,72,46,30,37,5,17,65,26.2,48,59,16,43,66,138,97,1,Matches
55,Yves Bissouma,ml MLI,MF,Brighton,22,1996,14.0,49,38,24,22,3,17,40,42.5,23,18,2,16,21,70,23,0,Matches
56,Willy Boly,ci CIV,DF,Wolves,28,1991,22.0,57,33,36,21,0,25,43,58.1,18,28,11,17,39,96,108,3,Matches
57,Gaëtan Bong,cm CMR,"DF,MF",Brighton,31,1988,0.7,1,0,0,0,1,0,0,,0,1,1,0,0,1,0,0,Matches
58,Sofiane Boufal,ma MAR,"MF,FW",Southampton,25,1993,8.5,16,8,6,5,5,6,15,40.0,9,17,0,17,4,20,1,0,Matches
59,Jarrod Bowen,eng ENG,"FW,MF",West Ham,22,1996,10.2,19,15,7,9,3,4,17,23.5,13,6,0,6,16,35,8,0,Matches
60,Robbie Brady,ie IRL,MF,Burnley,27,1992,5.0,11,9,5,4,2,3,10,30.0,7,10,2,8,5,16,8,0,Matches
61,Jarrad Branthwaite,eng ENG,DF,Everton,17,2002,3.3,8,7,5,3,0,3,5,60.0,2,6,3,3,2,10,12,0,Matches
62,Claudio Bravo,cl CHI,GK,Manchester City,36,1983,3.9,0,0,0,0,0,0,0,,0,0,0,0,0,0,1,1,Matches
63,Armando Broja,al ALB,FW,Chelsea,17,2001,0.1,0,0,0,0,0,0,0,,0,0,0,0,0,0,0,0,Matches
64,David Brooks,wls WAL,"MF,FW",Bournemouth,22,1997,5.6,5,5,1,2,2,2,14,14.3,12,5,1,4,2,7,1,0,Matches
65,Josh Brownhill,eng ENG,MF,Burnley,23,1995,8.9,14,8,5,7,2,5,13,38.5,8,9,4,5,14,28,18,0,Matches
66,Emi Buendía,ar ARG,"FW,MF",Norwich City,22,1996,27.4,82,39,57,21,4,38,118,32.2,80,58,5,53,23,105,32,2,Matches
67,Dan Burn,eng ENG,DF,Brighton,27,1992,32.0,67,42,35,27,5,25,53,47.2,28,44,20,24,42,109,130,0,Matches
68,Sam Byram,eng ENG,DF,Norwich City,25,1993,14.4,40,22,24,11,5,18,37,48.6,19,16,8,8,26,66,73,0,Matches
69,Willy Caballero,ar ARG,GK,Chelsea,37,1981,5.0,0,0,0,0,0,0,0,,0,0,0,0,0,0,3,0,Matches
70,Gary Cahill,eng ENG,DF,Crystal Palace,33,1985,24.1,15,8,11,4,0,7,15,46.7,8,34,25,9,18,33,114,1,Matches
71,Dominic Calvert-Lewin,eng ENG,FW,Everton,22,1997,29.2,7,5,1,4,2,1,10,10.0,9,15,2,13,6,13,36,0,Matches
72,Víctor Camarasa,es ESP,FW,Crystal Palace,25,1994,0.1,0,0,0,0,0,0,0,,0,0,0,0,0,0,0,0,Matches
73,João Cancelo,pt POR,DF,Manchester City,25,1994,13.4,40,24,21,12,7,24,40,60.0,16,9,2,7,21,61,18,0,Matches
74,Todd Cantwell,eng ENG,"FW,MF",Norwich City,21,1998,27.7,51,31,19,27,5,26,73,35.6,47,38,2,36,18,69,35,1,Matches
75,Étienne Capoue,fr FRA,MF,Watford,31,1988,29.2,75,40,38,30,7,37,85,43.5,48,30,11,19,68,143,61,0,Matches
76,Andy Carroll,eng ENG,FW,Newcastle Utd,30,1989,7.0,5,3,3,2,0,2,8,25.0,6,2,1,1,2,7,24,1,Matches
77,Jonny Castro,es ESP,"MF,DF",Wolves,25,1994,32.1,91,55,54,26,11,29,82,35.4,53,45,10,35,53,144,45,2,Matches
78,Craig Cathcart,nir NIR,DF,Watford,30,1989,27.6,41,26,25,15,1,10,24,41.7,14,19,16,3,25,66,136,1,Matches
79,Dani Ceballos,es ESP,MF,Arsenal,22,1996,18.8,45,23,26,14,5,18,61,29.5,43,14,3,11,32,77,16,1,Matches
80,Nathaniel Chalobah,eng ENG,MF,Watford,24,1994,10.3,30,11,13,13,4,12,27,44.4,15,10,4,6,18,48,20,0,Matches
81,Calum Chambers,eng ENG,DF,Arsenal,24,1995,12.2,26,10,12,8,6,11,16,68.8,5,13,7,6,16,42,43,1,Matches
82,Ben Chilwell,eng ENG,DF,Leicester City,22,1996,26.4,43,26,28,13,2,23,52,44.2,29,30,6,24,28,71,68,2,Matches
83,Tahith Chong,nl NED,"FW,DF",Manchester Utd,19,1999,0.4,0,0,0,0,0,0,0,,0,0,0,0,0,0,0,0,Matches
84,Hamza Choudhury,eng ENG,MF,Leicester City,21,1997,9.9,17,8,7,8,2,3,25,12.0,22,15,6,9,24,41,13,0,Matches
85,Andreas Christensen,dk DEN,DF,Chelsea,23,1996,19.5,38,21,25,12,1,15,21,71.4,6,12,8,4,29,67,56,0,Matches
86,Ciaran Clark,ie IRL,DF,Newcastle Utd,29,1989,13.2,20,12,18,2,0,9,15,60.0,6,18,14,4,11,31,82,0,Matches
87,Leon Clarke,eng ENG,"FW,MF",Sheffield Utd,34,1985,0.4,0,0,0,0,0,0,0,,0,0,0,0,0,0,2,0,Matches
88,Tom Cleverley,eng ENG,MF,Watford,29,1989,10.8,28,15,8,14,6,9,36,25.0,27,13,1,12,10,38,15,0,Matches
89,Conor Coady,eng ENG,DF,Wolves,26,1993,38.0,36,23,30,6,0,15,30,50.0,15,22,15,7,28,64,119,2,Matches
90,Séamus Coleman,ie IRL,DF,Everton,30,1988,20.4,42,31,24,14,4,19,25,76.0,6,21,9,12,24,66,43,1,Matches
91,Aaron Connolly,ie IRL,FW,Brighton,19,2000,14.0,7,6,1,4,2,3,10,30.0,7,11,0,11,0,7,3,0,Matches
92,Lewis Cook,eng ENG,"MF,FW",Bournemouth,22,1997,15.0,27,14,15,9,3,10,47,21.3,37,17,5,12,17,44,17,1,Matches
93,Steve Cook,eng ENG,DF,Bournemouth,28,1991,27.0,22,11,18,4,0,8,20,40.0,12,32,23,9,44,66,153,1,Matches
94,Jack Cork,eng ENG,MF,Burnley,30,1989,29.0,35,24,10,20,5,12,62,19.4,50,34,12,22,28,63,49,0,Matches
95,Aaron Cresswell,eng ENG,DF,West Ham,29,1989,30.3,43,26,21,18,4,23,46,50.0,23,33,10,23,35,78,75,2,Matches
96,Patrick Cutrone,it ITA,FW,Wolves,21,1998,3.3,4,2,2,1,1,1,5,20.0,4,1,1,0,2,6,1,0,Matches
97,Diogo Dalot,pt POR,"DF,MF",Manchester Utd,20,1999,0.7,3,2,3,0,0,3,4,75.0,1,1,0,1,2,5,1,0,Matches
98,Charlie Daniels,eng ENG,DF,Bournemouth,32,1986,1.4,1,1,0,1,0,0,1,0.0,1,2,0,2,1,2,5,1,Matches
99,Arnaut Danjuma,nl NED,MF,Bournemouth,22,1997,7.0,4,2,3,1,0,1,4,25.0,3,2,0,2,8,12,4,1,Matches
100,Scott Dann,eng ENG,DF,Crystal Palace,32,1987,14.1,8,4,7,1,0,8,14,57.1,6,9,7,2,14,22,67,0,Matches
101,Kevin Danso,at AUT,DF,Southampton,20,1998,3.1,6,4,3,3,0,4,7,57.1,3,7,3,4,2,8,7,0,Matches
102,Ben Davies,wls WAL,DF,Tottenham,26,1993,15.9,28,15,13,11,4,7,21,33.3,14,28,12,16,22,50,47,0,Matches
103,Tom Davies,eng ENG,MF,Everton,21,1998,22.5,38,17,12,22,4,17,55,30.9,38,12,4,8,35,73,28,0,Matches
104,Keinan Davis,eng ENG,FW,Aston Villa,21,1998,6.1,1,1,0,1,0,0,3,0.0,3,4,0,4,0,1,3,0,Matches
105,Craig Dawson,eng ENG,DF,Watford,29,1990,26.2,29,18,16,13,0,17,31,54.8,14,41,32,9,34,63,116,0,Matches
106,Kevin De Bruyne,be BEL,MF,Manchester City,28,1991,31.0,45,24,8,20,17,18,66,27.3,48,26,4,22,18,63,24,2,Matches
107,Troy Deeney,eng ENG,FW,Watford,31,1988,24.7,19,12,6,10,3,6,29,20.7,23,13,1,12,11,30,27,0,Matches
108,Fabian Delph,eng ENG,MF,Everton,29,1989,13.2,26,12,10,13,3,9,22,40.9,13,12,3,9,15,41,19,1,Matches
109,Leander Dendoncker,be BEL,"MF,DF",Wolves,24,1995,31.1,68,31,41,19,8,28,67,41.8,39,39,12,27,38,106,64,2,Matches
110,Gerard Deulofeu,es ESP,FW,Watford,25,1994,23.3,33,16,18,9,6,12,59,20.3,47,10,0,10,25,58,6,0,Matches
111,Eric Dier,eng ENG,"DF,MF",Tottenham,25,1994,14.9,21,12,10,10,1,10,20,50.0,10,14,9,5,21,42,65,0,Matches
112,Lucas Digne,fr FRA,DF,Everton,26,1993,33.7,73,49,49,19,5,33,68,48.5,35,39,10,29,42,115,108,0,Matches
113,Issa Diop,fr FRA,DF,West Ham,22,1997,30.7,27,15,18,9,0,16,25,64.0,9,37,21,16,47,74,166,2,Matches
114,Moussa Djenepo,ml MLI,"MF,DF",Southampton,21,1998,10.3,27,21,13,9,5,11,21,52.4,10,15,1,14,9,36,9,0,Matches
115,Matt Doherty,ie IRL,"MF,DF",Wolves,27,1992,31.5,55,29,34,17,4,27,41,65.9,14,34,4,30,40,95,52,1,Matches
116,Abdoulaye Doucouré,ml MLI,MF,Watford,26,1993,35.1,64,30,29,29,6,16,57,28.1,41,46,8,38,31,95,32,0,Matches
117,Tommy Doyle,eng ENG,MF,Manchester City,17,2001,0.2,0,0,0,0,0,0,1,0.0,1,0,0,0,0,0,0,0,Matches
118,Danny Drinkwater,eng ENG,MF,Aston Villa,29,1990,2.9,5,3,3,2,0,2,18,11.1,16,5,0,5,5,10,5,1,Matches
119,Danny Drinkwater,eng ENG,MF,Burnley,29,1990,0.6,2,1,1,1,0,0,1,0.0,1,0,0,0,1,3,0,0,Matches
120,Josip Drmić,ch SUI,FW,Norwich City,26,1992,7.2,3,2,1,2,0,0,8,0.0,8,6,0,6,1,4,5,1,Matches
121,Martin Dúbravka,sk SVK,GK,Newcastle Utd,30,1989,38.0,1,1,1,0,0,1,2,50.0,1,2,0,2,1,2,17,5,Matches
122,Ondrej Duda,sk SVK,MF,Norwich City,24,1994,8.0,18,11,9,6,3,7,16,43.8,9,10,2,8,6,24,8,0,Matches
123,Shane Duffy,ie IRL,DF,Brighton,27,1992,13.8,18,9,14,4,0,6,17,35.3,11,13,7,6,21,39,72,0,Matches
124,Paul Dummett,wls WAL,DF,Newcastle Utd,27,1991,13.6,27,17,19,7,1,21,27,77.8,6,23,9,14,23,50,69,0,Matches
125,Lewis Dunk,eng ENG,DF,Brighton,27,1991,35.9,40,24,23,17,0,15,34,44.1,19,55,33,22,55,95,125,2,Matches
126,Ederson,br BRA,GK,Manchester City,25,1993,34.1,2,2,2,0,0,2,5,40.0,3,0,0,0,3,5,16,6,Matches
127,John Egan,ie IRL,DF,Sheffield Utd,26,1992,35.4,44,27,34,10,0,25,45,55.6,20,39,27,12,58,102,171,4,Matches
128,Harvey Elliott,eng ENG,DF,Liverpool,16,2003,0.1,0,0,0,0,0,0,0,,0,0,0,0,0,0,0,0,Matches
129,Ahmed Elmohamady,eg EGY,DF,Aston Villa,31,1987,11.5,19,9,10,7,2,10,21,47.6,11,11,5,6,13,32,25,1,Matches
130,Björn Engels,be BEL,DF,Aston Villa,24,1994,16.1,11,6,8,2,1,8,13,61.5,5,18,17,1,28,39,86,3,Matches
131,Christian Eriksen,dk DEN,"MF,FW",Tottenham,27,1992,12.2,19,9,10,8,1,7,24,29.2,17,10,1,9,12,31,16,0,Matches
132,Jonny Evans,nir NIR,DF,Leicester City,31,1988,37.6,48,34,33,14,1,28,39,71.8,11,33,18,15,57,105,174,4,Matches
133,Łukasz Fabiański,pl POL,GK,West Ham,34,1985,23.5,2,2,2,0,0,2,4,50.0,2,0,0,0,1,3,5,3,Matches
134,Fabinho,br BRA,MF,Liverpool,25,1993,23.1,62,35,20,35,7,26,67,38.8,41,25,2,23,34,96,19,1,Matches
135,Ralf Fährmann,de GER,GK,Norwich City,30,1988,0.2,0,0,0,0,0,0,0,,0,0,0,0,0,0,0,0,Matches
136,Akin Famewo,eng ENG,MF,Norwich City,20,1998,0.0,0,0,0,0,0,0,0,,0,0,0,0,0,0,0,0,Matches
137,Kiko Femenía,es ESP,DF,Watford,28,1991,24.9,68,38,49,17,2,43,80,53.8,37,16,2,14,36,104,49,0,Matches
138,Bruno Fernandes,pt POR,MF,Manchester Utd,24,1994,13.2,22,12,9,9,4,5,38,13.2,33,6,0,6,11,33,16,0,Matches
139,Gedson Fernandes,pt POR,"MF,DF",Tottenham,20,1999,0.8,2,0,2,0,0,0,2,0.0,2,2,0,2,1,3,0,0,Matches
140,Federico Fernández,ar ARG,DF,Newcastle Utd,30,1989,29.1,42,25,30,10,2,23,46,50.0,23,41,28,13,24,66,190,2,Matches
141,Fernandinho,br BRA,DF,Manchester City,34,1985,26.6,50,35,32,16,2,29,48,60.4,19,28,16,12,25,75,82,0,Matches
142,Roberto Firmino,br BRA,FW,Liverpool,27,1991,33.2,37,19,8,14,15,10,43,23.3,33,34,3,31,7,44,11,1,Matches
143,John Fleck,sct SCO,MF,Sheffield Utd,27,1991,28.0,36,25,13,14,9,22,64,34.4,42,25,3,22,24,60,26,0,Matches
144,Phil Foden,eng ENG,"FW,MF",Manchester City,19,2000,10.0,14,10,4,6,4,6,19,31.6,13,5,0,5,6,20,2,0,Matches
145,Pablo Fornals,es ESP,"MF,FW",West Ham,23,1996,24.1,46,28,21,18,7,19,64,29.7,45,35,1,34,25,71,15,0,Matches
146,Ben Foster,eng ENG,GK,Watford,36,1983,38.0,1,0,1,0,0,1,3,33.3,2,1,0,1,0,1,16,2,Matches
147,Timothy Fosu-Mensah,nl NED,DF,Manchester Utd,21,1998,1.5,1,1,0,1,0,1,4,25.0,3,0,0,0,4,5,1,0,Matches
148,Dimitri Foulquier,fr FRA,"DF,MF",Watford,26,1993,0.7,1,0,1,0,0,0,0,,0,1,0,1,2,3,2,0,Matches
149,Juan Foyth,ar ARG,DF,Tottenham,21,1998,0.8,7,3,5,2,0,3,4,75.0,1,1,0,1,1,8,3,1,Matches
150,Simon Francis,eng ENG,DF,Bournemouth,34,1985,10.8,13,9,11,2,0,11,21,52.4,10,17,12,5,20,33,71,0,Matches
151,Ryan Fraser,sct SCO,"MF,FW",Bournemouth,25,1994,23.0,12,6,5,5,2,7,22,31.8,15,15,3,12,15,27,24,0,Matches
152,Fred,br BRA,MF,Manchester Utd,26,1993,24.0,60,32,33,22,5,25,100,25.0,75,44,8,36,38,98,32,0,Matches
153,Ryan Fredericks,eng ENG,DF,West Ham,26,1992,24.9,82,56,59,18,5,41,64,64.1,23,20,10,10,24,106,73,1,Matches
154,Kieron Freeman,wls WAL,FW,Sheffield Utd,27,1992,0.1,0,0,0,0,0,0,0,,0,0,0,0,0,0,0,0,Matches
155,Luke Freeman,eng ENG,MF,Sheffield Utd,27,1992,4.1,6,4,2,2,2,2,8,25.0,6,1,0,1,10,16,6,0,Matches
156,Christian Fuchs,at AUT,DF,Leicester City,33,1986,8.6,14,9,8,6,0,8,19,42.1,11,8,3,5,17,31,33,1,Matches
157,Eric García,es ESP,DF,Manchester City,18,2001,8.8,6,1,4,2,0,5,9,55.6,4,2,0,2,18,24,33,0,Matches
158,James Garner,eng ENG,MF,Manchester Utd,18,2001,0.1,0,0,0,0,0,0,1,0.0,1,0,0,0,0,0,1,0,Matches
159,Dwight Gayle,eng ENG,FW,Newcastle Utd,28,1990,9.4,12,10,4,6,2,4,8,50.0,4,5,0,5,2,14,9,0,Matches
160,Paulo Gazzaniga,ar ARG,GK,Tottenham,27,1992,17.9,0,0,0,0,0,0,0,,0,0,0,0,1,1,4,1,Matches
161,Jean-Philippe Gbamin,ci CIV,MF,Everton,23,1995,1.5,4,3,1,1,2,1,2,50.0,1,1,0,1,1,5,4,0,Matches
162,David de Gea,es ESP,GK,Manchester Utd,28,1990,38.0,0,0,0,0,0,0,0,,0,0,0,0,0,0,7,4,Matches
163,Anwar El Ghazi,nl NED,"FW,MF",Aston Villa,24,1995,22.8,20,11,12,5,3,8,26,30.8,18,10,1,9,13,33,16,1,Matches
164,Morgan Gibbs-White,eng ENG,"MF,FW",Wolves,19,2000,1.4,0,0,0,0,0,0,0,,0,0,0,0,2,2,0,0,Matches
165,Billy Gilmour,sct SCO,MF,Chelsea,18,2001,2.2,5,2,3,2,0,2,4,50.0,2,2,0,2,3,8,3,1,Matches
166,Olivier Giroud,fr FRA,FW,Chelsea,32,1986,11.0,8,3,2,5,1,1,11,9.1,10,14,1,13,2,10,13,0,Matches
167,Ben Godfrey,eng ENG,DF,Norwich City,21,1998,29.4,22,14,18,3,1,10,18,55.6,8,41,37,4,25,47,152,3,Matches
168,André Gomes,pt POR,MF,Everton,26,1993,16.2,22,15,7,11,4,8,62,12.9,54,20,3,17,7,29,7,0,Matches
169,Angel Gomes,eng ENG,MF,Manchester Utd,18,2000,0.2,0,0,0,0,0,0,0,,0,1,0,1,0,0,0,0,Matches
170,Joe Gomez,eng ENG,DF,Liverpool,22,1997,22.3,23,16,17,6,0,9,20,45.0,11,15,8,7,38,61,64,2,Matches
171,Anthony Gordon,eng ENG,"MF,FW",Everton,18,2001,4.9,11,7,5,6,0,5,15,33.3,10,6,2,4,8,19,4,0,Matches
172,Dan Gosling,eng ENG,MF,Bournemouth,29,1990,14.0,26,10,14,9,3,6,27,22.2,21,31,11,20,20,46,26,0,Matches
173,Andre Gray,jm JAM,FW,Watford,28,1991,8.4,4,3,0,2,2,1,3,33.3,2,4,1,3,1,5,2,0,Matches
174,Demarai Gray,jm JAM,"MF,FW",Leicester City,23,1996,6.9,12,6,6,6,0,6,12,50.0,6,7,0,7,5,17,4,0,Matches
175,Jack Grealish,eng ENG,"FW,MF",Aston Villa,23,1995,35.9,29,19,12,12,5,13,34,38.2,21,33,12,21,22,51,22,1,Matches
176,Mason Greenwood,eng ENG,FW,Manchester Utd,17,2001,14.7,17,11,5,6,6,5,20,25.0,15,9,0,9,6,23,6,1,Matches
177,Pascal Groß,de GER,"MF,FW",Brighton,28,1991,20.0,36,13,8,21,7,14,39,35.9,25,25,3,22,9,45,7,0,Matches
178,Vicente Guaita,es ESP,GK,Crystal Palace,32,1987,35.0,1,1,1,0,0,1,2,50.0,1,0,0,0,0,1,18,3,Matches
179,Mattéo Guendouzi,fr FRA,MF,Arsenal,20,1999,19.4,31,16,14,13,4,14,43,32.6,29,21,7,14,29,60,38,2,Matches
180,Frederic Guilbert,fr FRA,"DF,MF",Aston Villa,24,1994,22.7,74,43,48,20,6,36,67,53.7,31,33,10,23,49,123,74,2,Matches
181,İlkay Gündoğan,de GER,MF,Manchester City,28,1990,22.4,27,16,9,11,7,9,41,22.0,32,17,5,12,31,58,13,0,Matches
182,Angus Gunn,sct SCO,GK,Southampton,23,1996,10.0,1,1,1,0,0,1,3,33.3,2,0,0,0,0,1,1,0,Matches
183,Sébastien Haller,ci CIV,FW,West Ham,25,1994,25.2,22,15,8,10,4,3,30,10.0,27,19,5,14,8,30,27,0,Matches
184,Grant Hanley,sct SCO,DF,Norwich City,27,1991,14.0,24,15,17,7,0,8,14,57.1,6,25,18,7,31,55,77,1,Matches
185,Kortney Hause,eng ENG,DF,Aston Villa,24,1995,17.2,21,9,15,5,1,8,15,53.3,7,27,19,8,20,41,98,4,Matches
186,Isaac Hayden,eng ENG,MF,Newcastle Utd,24,1995,24.7,55,27,33,17,5,20,50,40.0,30,24,7,17,38,93,38,0,Matches
187,Tom Heaton,eng ENG,GK,Aston Villa,33,1986,19.9,3,2,3,0,0,3,4,75.0,1,0,0,0,0,3,6,0,Matches
188,Dean Henderson,eng ENG,GK,Sheffield Utd,22,1997,36.0,0,0,0,0,0,0,0,,0,0,0,0,1,1,13,1,Matches
189,Jordan Henderson,eng ENG,MF,Liverpool,29,1990,24.9,63,41,18,33,12,22,55,40.0,33,22,4,18,30,93,21,2,Matches
190,Jeff Hendrick,ie IRL,MF,Burnley,27,1992,21.5,18,10,7,8,3,7,27,25.9,20,21,8,13,20,38,20,0,Matches
191,Wayne Hennessey,wls WAL,GK,Crystal Palace,32,1987,3.0,0,0,0,0,0,0,0,,0,0,0,0,1,1,3,1,Matches
192,Javier Hernández,mx MEX,FW,West Ham,31,1988,1.2,0,0,0,0,0,0,1,0.0,1,0,0,0,1,1,0,0,Matches
193,Onel Hernández,cu CUB,"FW,MF",Norwich City,26,1993,15.4,27,19,13,11,3,9,31,29.0,22,12,1,11,19,46,10,0,Matches
194,Son Heung-min,kr KOR,FW,Tottenham,27,1992,27.5,23,15,10,11,2,9,57,15.8,48,23,0,23,19,42,18,1,Matches
195,George Hirst,eng ENG,"MF,DF",Leicester City,20,1999,0.1,0,0,0,0,0,0,0,,0,0,0,0,0,0,0,0,Matches
196,Rob Holding,eng ENG,DF,Arsenal,23,1995,6.5,4,2,3,1,0,1,3,33.3,2,10,6,4,5,9,45,1,Matches
197,José Holebas,gr GRE,DF,Watford,35,1984,11.4,26,15,19,7,0,9,28,32.1,19,11,4,7,3,29,33,0,Matches
198,Mason Holgate,eng ENG,DF,Everton,22,1996,22.8,44,26,30,13,1,21,31,67.7,10,26,13,13,34,78,97,0,Matches
199,Nathan Holland,eng ENG,MF,West Ham,21,1998,0.4,3,1,2,1,0,0,0,,0,1,0,1,0,3,0,0,Matches
200,Conor Hourihane,ie IRL,MF,Aston Villa,28,1991,17.0,16,10,4,8,4,10,25,40.0,15,19,4,15,9,25,31,0,Matches
201,Callum Hudson-Odoi,eng ENG,"FW,MF",Chelsea,18,2000,9.6,10,4,4,5,1,1,7,14.3,6,9,0,9,5,15,4,1,Matches
202,Will Hughes,eng ENG,MF,Watford,24,1995,25.0,75,47,24,41,10,25,67,37.3,42,48,8,40,37,112,28,0,Matches
203,Pierre Højbjerg,dk DEN,MF,Southampton,23,1995,30.6,80,49,34,38,8,39,91,42.9,52,44,5,39,46,126,54,2,Matches
204,Jordon Ibe,eng ENG,DF,Bournemouth,23,1995,0.6,2,2,2,0,0,1,1,100.0,0,0,0,0,0,2,1,0,Matches
205,Adam Idah,ie IRL,"FW,MF",Norwich City,18,2001,2.5,2,2,1,0,1,2,3,66.7,1,4,0,4,0,2,1,0,Matches
206,Odion Ighalo,ng NGA,FW,Manchester Utd,30,1989,1.1,2,2,0,2,0,1,3,33.3,2,1,1,0,0,2,0,0,Matches
207,Kelechi Iheanacho,ng NGA,FW,Leicester City,22,1996,10.7,3,1,1,2,0,1,9,11.1,8,8,1,7,3,6,8,0,Matches
208,Danny Ings,eng ENG,FW,Southampton,27,1992,31.2,42,25,16,16,10,13,67,19.4,54,62,4,58,9,51,30,1,Matches
209,Alex Iwobi,ng NGA,"MF,FW",Everton,23,1996,17.7,25,17,8,15,2,12,33,36.4,21,18,2,16,14,39,10,1,Matches
210,Phil Jagielka,eng ENG,DF,Sheffield Utd,36,1982,2.7,5,4,3,2,0,1,3,33.3,2,5,5,0,4,9,19,0,Matches
211,Alireza Jahanbakhsh,ir IRN,"FW,MF",Brighton,25,1993,3.5,8,4,3,2,3,0,2,0.0,2,5,0,5,3,11,2,0,Matches
212,Daniel James,wls WAL,FW,Manchester Utd,21,1997,25.4,20,10,5,10,5,7,45,15.6,38,23,4,19,7,27,12,0,Matches
213,Matty James,eng ENG,MF,Leicester City,28,1991,0.1,0,0,0,0,0,0,0,,0,0,0,0,0,0,0,0,Matches
214,Reece James,eng ENG,DF,Chelsea,19,1999,16.8,36,23,18,14,4,11,29,37.9,18,19,8,11,22,58,28,0,Matches
215,Daryl Janmaat,nl NED,DF,Watford,30,1989,6.7,14,10,8,6,0,6,13,46.2,7,7,2,5,7,21,23,0,Matches
216,Gabriel Jesus,br BRA,FW,Manchester City,22,1997,22.6,17,10,4,5,8,7,25,28.0,18,26,1,25,11,28,6,0,Matches
217,Raúl Jiménez,mx MEX,FW,Wolves,28,1991,36.0,20,12,6,10,4,3,31,9.7,28,26,0,26,16,36,34,1,Matches
218,João Pedro,br BRA,"FW,MF",Watford,17,2001,0.3,0,0,0,0,0,0,0,,0,0,0,0,0,0,0,0,Matches
219,Joelinton,br BRA,FW,Newcastle Utd,22,1996,29.8,34,20,7,22,5,9,32,28.1,23,32,6,26,11,45,30,0,Matches
220,Ben Johnson,eng ENG,DF,West Ham,19,2000,3.0,8,4,7,1,0,7,10,70.0,3,5,2,3,3,11,11,0,Matches
221,Curtis Jones,eng ENG,MF,Liverpool,18,2001,1.4,4,4,0,1,3,3,4,75.0,1,2,0,2,2,6,1,0,Matches
222,Phil Jones,eng ENG,DF,Manchester Utd,27,1992,1.5,2,2,1,1,0,1,1,100.0,0,2,0,2,2,4,9,1,Matches
223,Bruno Jordão,pt POR,FW,Wolves,20,1998,0.1,0,0,0,0,0,0,0,,0,1,0,1,0,0,0,0,Matches
224,Jorginho,it ITA,MF,Chelsea,27,1991,26.4,66,40,24,34,8,35,91,38.5,56,30,5,25,64,130,27,2,Matches
225,Jota,es ESP,"FW,MF",Aston Villa,28,1991,3.7,3,1,2,0,1,2,5,40.0,3,1,0,1,3,6,6,0,Matches
226,Diogo Jota,pt POR,FW,Wolves,22,1996,25.4,28,15,16,10,2,12,48,25.0,36,17,0,17,9,37,10,2,Matches
227,James Justin,eng ENG,"DF,MF",Leicester City,21,1998,11.2,36,17,22,14,0,15,25,60.0,10,15,7,8,11,47,30,0,Matches
228,Christian Kabasele,be BEL,DF,Watford,28,1991,25.0,37,24,26,11,0,17,32,53.1,15,31,23,8,36,73,127,0,Matches
229,Harry Kane,eng ENG,FW,Tottenham,26,1993,28.7,18,12,3,12,3,4,17,23.5,13,17,7,10,6,24,30,0,Matches
230,N'Golo Kanté,fr FRA,MF,Chelsea,28,1991,19.2,44,20,22,14,8,17,36,47.2,19,29,5,24,44,88,32,2,Matches
231,Moise Kean,it ITA,FW,Everton,19,2000,9.5,6,6,5,1,0,0,0,,0,4,0,4,5,11,1,1,Matches
232,Michael Keane,eng ENG,DF,Everton,26,1993,28.4,31,16,18,12,1,14,24,58.3,10,35,28,7,44,75,152,0,Matches
233,Naby Keïta,gn GUI,MF,Liverpool,24,1995,9.1,30,14,8,16,6,11,26,42.3,15,18,0,18,10,40,4,0,Matches
234,Lloyd Kelly,eng ENG,DF,Bournemouth,20,1998,7.1,7,3,3,4,0,6,7,85.7,1,9,5,4,6,13,15,1,Matches
235,Martin Kelly,eng ENG,DF,Crystal Palace,29,1990,17.2,23,18,19,4,0,14,31,45.2,17,18,10,8,16,39,86,1,Matches
236,Max Kilman,eng ENG,DF,Wolves,22,1997,2.1,4,2,1,3,0,2,2,100.0,0,1,1,0,4,8,7,0,Matches
237,Joshua King,no NOR,"FW,MF",Bournemouth,27,1992,22.3,16,6,4,8,4,4,16,25.0,12,20,3,17,8,24,9,0,Matches
238,Timm Klose,ch SUI,DF,Norwich City,31,1988,6.5,8,2,5,2,1,7,11,63.6,4,6,6,0,7,15,29,0,Matches
239,Jonathan Kodjia,ci CIV,FW,Aston Villa,29,1989,1.3,0,0,0,0,0,0,1,0.0,1,0,0,0,0,0,1,0,Matches
240,Sead Kolašinac,ba BIH,DF,Arsenal,26,1993,18.9,29,16,18,6,5,12,23,52.2,11,14,4,10,25,54,34,1,Matches
241,Ezri Konsa,eng ENG,DF,Aston Villa,21,1997,22.7,18,9,12,6,0,7,16,43.8,9,34,24,10,25,43,70,2,Matches
242,Cheikhou Kouyaté,sn SEN,"MF,DF",Crystal Palace,29,1989,28.1,67,32,43,20,4,26,48,54.2,22,35,11,24,43,110,58,1,Matches
243,Mateo Kovačić,hr CRO,MF,Chelsea,25,1994,23.0,63,38,29,32,2,26,65,40.0,39,15,1,14,22,85,16,1,Matches
244,Emil Krafth,se SWE,DF,Newcastle Utd,24,1994,11.3,18,12,15,2,1,9,20,45.0,11,11,8,3,8,26,45,0,Matches
245,Tim Krul,nl NED,GK,Norwich City,31,1988,36.0,0,0,0,0,0,0,1,0.0,1,2,0,2,1,1,13,1,Matches
246,Alexandre Lacazette,fr FRA,FW,Arsenal,28,1991,20.8,31,16,8,21,2,9,24,37.5,15,14,0,14,7,38,15,0,Matches
247,Adam Lallana,eng ENG,"MF,FW",Liverpool,31,1988,4.2,19,9,7,9,3,6,21,28.6,15,7,0,7,5,24,3,0,Matches
248,Érik Lamela,ar ARG,"MF,FW",Tottenham,27,1992,13.5,24,20,9,13,2,2,21,9.5,19,12,3,9,8,32,10,0,Matches
249,Tariq Lamptey,gh GHA,DF,Chelsea,18,2000,0.4,2,2,1,1,0,2,2,100.0,0,0,0,0,0,2,0,0,Matches
250,Tariq Lamptey,gh GHA,DF,Brighton,18,2000,6.5,7,6,6,1,0,2,9,22.2,7,6,0,6,16,23,17,0,Matches
251,Henri Lansbury,eng ENG,MF,Aston Villa,28,1990,2.2,6,2,3,1,2,2,8,25.0,6,4,0,4,0,6,3,0,Matches
252,Manuel Lanzini,ar ARG,"MF,FW",West Ham,26,1993,15.3,14,9,6,6,2,7,39,17.9,32,9,1,8,10,24,3,0,Matches
253,Aymeric Laporte,es ESP,DF,Manchester City,25,1994,12.2,13,6,6,7,0,4,9,44.4,5,6,5,1,20,33,26,1,Matches
254,Jamaal Lascelles,eng ENG,DF,Newcastle Utd,25,1993,23.1,14,3,10,4,0,4,9,44.4,5,23,20,3,28,42,116,1,Matches
255,Valentino Lazaro,at AUT,"DF,MF",Newcastle Utd,23,1996,5.3,13,9,11,2,0,11,18,61.1,7,2,0,2,3,16,4,0,Matches
256,Moritz Leitner,de GER,MF,Norwich City,26,1992,7.6,16,9,8,7,1,9,25,36.0,16,14,4,10,9,25,10,1,Matches
257,Florian Lejeune,fr FRA,DF,Newcastle Utd,28,1991,4.9,8,2,6,2,0,4,7,57.1,3,6,2,4,10,18,15,2,Matches
258,Aaron Lennon,eng ENG,MF,Burnley,32,1987,5.5,14,8,7,4,3,7,10,70.0,3,6,1,5,8,22,3,0,Matches
259,Bernd Leno,de GER,GK,Arsenal,27,1992,29.4,0,0,0,0,0,0,2,0.0,2,0,0,0,0,0,9,2,Matches
260,Jefferson Lerma,co COL,MF,Bournemouth,24,1994,30.0,54,32,17,31,6,22,48,45.8,26,28,12,16,57,111,54,1,Matches
261,Jamal Lewis,nir NIR,DF,Norwich City,21,1998,25.6,51,35,42,6,3,22,36,61.1,14,27,12,15,25,76,68,0,Matches
262,Victor Lindelöf,se SWE,DF,Manchester Utd,25,1994,34.4,29,15,16,12,1,17,20,85.0,3,25,16,9,26,55,129,0,Matches
263,Jesse Lingard,eng ENG,"MF,FW",Manchester Utd,26,1992,10.4,15,8,6,4,5,5,18,27.8,13,5,0,5,3,18,0,0,Matches
264,Hugo Lloris,fr FRA,GK,Tottenham,32,1986,20.1,0,0,0,0,0,0,0,,0,0,0,0,1,1,3,2,Matches
265,Giovani Lo Celso,ar ARG,"MF,FW",Tottenham,23,1996,16.6,51,29,12,33,6,12,59,20.3,47,20,4,16,9,60,19,0,Matches
266,Jürgen Locadia,cw CUW,"FW,MF",Brighton,25,1993,1.0,0,0,0,0,0,0,0,,0,0,0,0,0,0,0,0,Matches
267,Ruben Loftus-Cheek,eng ENG,"MF,FW",Chelsea,23,1996,2.3,0,0,0,0,0,0,2,0.0,2,1,1,0,2,2,2,0,Matches
268,Kevin Long,ie IRL,DF,Burnley,28,1990,6.3,7,5,6,1,0,4,9,44.4,5,9,7,2,4,11,31,0,Matches
269,Shane Long,ie IRL,FW,Southampton,32,1987,15.5,19,10,5,8,6,7,19,36.8,12,12,0,12,4,23,16,0,Matches
270,Matthew Longstaff,eng ENG,MF,Newcastle Utd,19,2000,6.4,3,1,2,1,0,3,14,21.4,11,4,1,3,5,8,3,0,Matches
271,Sean Longstaff,eng ENG,MF,Newcastle Utd,21,1997,15.3,35,19,17,16,2,20,50,40.0,30,23,5,18,19,54,20,2,Matches
272,Dejan Lovren,hr CRO,DF,Liverpool,30,1989,8.6,13,8,10,3,0,7,12,58.3,5,9,6,3,10,23,42,0,Matches
273,Matthew Lowton,eng ENG,DF,Burnley,30,1989,17.0,41,22,20,18,3,22,33,66.7,11,20,6,14,27,68,57,1,Matches
274,David Luiz,br BRA,DF,Arsenal,32,1987,31.2,28,16,14,14,0,13,24,54.2,11,42,37,5,32,60,133,2,Matches
275,Douglas Luiz,br BRA,MF,Aston Villa,21,1998,29.0,46,24,25,17,4,19,65,29.2,46,42,15,27,36,82,54,1,Matches
276,John Lundstram,eng ENG,MF,Sheffield Utd,25,1994,27.3,46,30,18,21,7,21,65,32.3,44,18,4,14,33,79,46,1,Matches
277,Alexis Mac Allister,ar ARG,"MF,FW",Brighton,20,1998,3.9,9,5,4,3,2,5,9,55.6,4,12,0,12,1,10,2,0,Matches
278,James Maddison,eng ENG,MF,Leicester City,22,1996,29.2,59,30,13,31,15,23,68,33.8,45,16,0,16,9,68,7,1,Matches
279,Harry Maguire,eng ENG,DF,Manchester Utd,26,1993,38.0,37,23,23,14,0,18,34,52.9,16,31,22,9,72,109,159,0,Matches
280,Riyad Mahrez,dz ALG,"FW,MF",Manchester City,28,1991,21.6,28,14,11,9,8,11,38,28.9,27,31,1,30,18,46,8,2,Matches
281,Ainsley Maitland-Niles,eng ENG,DF,Arsenal,21,1997,15.4,41,23,34,5,2,22,43,51.2,21,12,3,9,28,69,38,0,Matches
282,Sadio Mané,sn SEN,FW,Liverpool,27,1992,30.5,44,32,9,20,15,13,40,32.5,27,19,0,19,13,57,11,2,Matches
283,Javier Manquillo,es ESP,DF,Newcastle Utd,25,1994,17.8,39,26,27,8,4,24,38,63.2,14,14,2,12,18,57,56,0,Matches
284,Solly March,eng ENG,"FW,MF",Brighton,25,1994,12.7,25,12,16,6,3,9,19,47.4,10,16,4,12,20,45,14,2,Matches
285,Pablo Marí,es ESP,DF,Arsenal,25,1993,1.3,2,1,2,0,0,0,0,,0,0,0,0,1,3,10,0,Matches
286,Adrian Mariappa,jm JAM,DF,Watford,32,1986,16.8,20,14,15,4,1,11,30,36.7,19,22,7,15,11,31,73,0,Matches
287,Anthony Martial,fr FRA,FW,Manchester Utd,23,1995,29.2,15,12,1,4,10,1,16,6.3,15,18,1,17,5,20,17,0,Matches
288,David Martin,eng ENG,GK,West Ham,33,1986,4.8,0,0,0,0,0,0,0,,0,0,0,0,0,0,1,1,Matches
289,Josh Martin,eng ENG,"FW,MF",Norwich City,17,2001,0.4,1,0,0,0,1,0,0,,0,1,0,1,1,2,0,0,Matches
290,Gabriel Martinelli,br BRA,FW,Arsenal,18,2001,7.4,20,15,10,6,4,7,20,35.0,13,15,1,14,3,23,8,0,Matches
291,Emiliano Martínez,ar ARG,GK,Arsenal,26,1992,8.6,0,0,0,0,0,0,0,,0,0,0,0,0,0,1,0,Matches
292,Adam Masina,ma MAR,DF,Watford,25,1994,20.2,38,22,24,11,3,14,37,37.8,23,26,12,14,28,66,66,0,Matches
293,Arthur Masuaku,cd COD,DF,West Ham,25,1993,10.4,41,23,24,13,4,23,39,59.0,16,19,5,14,14,55,23,0,Matches
294,Juan Mata,es ESP,"MF,FW",Manchester Utd,31,1988,8.4,7,3,1,5,1,2,7,28.6,5,5,1,4,0,7,2,0,Matches
295,Nemanja Matić,rs SRB,MF,Manchester Utd,30,1988,17.6,46,24,23,19,4,20,43,46.5,23,21,8,13,22,68,28,1,Matches
296,Joël Matip,cm CMR,DF,Liverpool,27,1991,7.8,13,9,4,7,2,4,11,36.4,7,8,4,4,12,25,38,0,Matches
297,Neal Maupay,fr FRA,FW,Brighton,22,1996,30.7,20,12,1,13,6,9,29,31.0,20,24,0,24,4,24,10,0,Matches
298,James McArthur,sct SCO,MF,Crystal Palace,31,1987,34.3,88,51,43,34,11,37,106,34.9,69,69,19,50,60,148,56,0,Matches
299,Oliver McBurnie,sct SCO,FW,Sheffield Utd,23,1996,23.5,37,22,6,27,4,11,40,27.5,29,25,3,22,15,52,43,0,Matches
300,Alex McCarthy,eng ENG,GK,Southampton,29,1989,28.0,1,1,1,0,0,1,1,100.0,0,1,0,1,0,1,11,3,Matches
301,James McCarthy,ie IRL,MF,Crystal Palace,28,1990,18.7,82,47,36,36,10,40,76,52.6,36,24,5,19,24,106,11,0,Matches
302,John McGinn,sct SCO,MF,Aston Villa,24,1994,25.7,53,35,19,23,11,18,62,29.0,44,25,1,24,25,78,18,0,Matches
303,David McGoldrick,ie IRL,FW,Sheffield Utd,31,1987,20.2,41,26,9,24,8,5,20,25.0,15,14,2,12,3,44,23,0,Matches
304,Michael McGovern,nir NIR,GK,Norwich City,35,1984,1.8,0,0,0,0,0,0,0,,0,0,0,0,0,0,1,1,Matches
305,Kenny McLean,sct SCO,MF,Norwich City,27,1992,33.0,44,29,20,18,6,14,42,33.3,28,32,7,25,38,82,67,2,Matches
306,Dwight McNeil,eng ENG,MF,Burnley,19,1999,37.1,47,33,18,22,7,23,71,32.4,48,60,8,52,30,77,34,0,Matches
307,Scott McTominay,sct SCO,MF,Manchester Utd,22,1996,19.7,43,22,14,25,4,17,32,53.1,15,25,5,20,31,74,34,2,Matches
308,Ben Mee,eng ENG,DF,Burnley,29,1989,32.0,41,22,25,16,0,17,29,58.6,12,42,31,11,42,83,165,2,Matches
309,Benjamin Mendy,fr FRA,DF,Manchester City,25,1994,16.6,18,15,7,7,4,9,27,33.3,18,10,2,8,16,34,21,3,Matches
310,Nampalys Mendy,sn SEN,MF,Leicester City,27,1992,3.2,7,5,4,1,2,4,5,80.0,1,4,1,3,6,13,6,0,Matches
311,Chris Mepham,wls WAL,DF,Bournemouth,21,1997,10.1,20,9,13,7,0,11,14,78.6,3,17,11,6,17,37,62,1,Matches
312,Max Meyer,de GER,"MF,FW",Crystal Palace,23,1995,7.3,19,11,10,9,0,8,18,44.4,10,6,1,5,7,26,4,0,Matches
313,Luka Milivojević,rs SRB,MF,Crystal Palace,28,1991,27.9,61,32,32,25,4,35,84,41.7,49,30,7,23,42,103,39,4,Matches
314,James Milner,eng ENG,"MF,DF",Liverpool,33,1986,10.4,16,10,3,10,3,6,26,23.1,20,12,3,9,7,23,17,1,Matches
315,Yerry Mina,co COL,DF,Everton,24,1994,25.4,39,22,25,12,2,18,24,75.0,6,20,14,6,28,67,102,1,Matches
316,Takumi Minamino,jp JPN,"FW,MF",Liverpool,24,1995,2.8,3,3,0,2,1,2,10,20.0,8,3,0,3,0,3,3,0,Matches
317,Tyrone Mings,eng ENG,DF,Aston Villa,26,1993,32.2,15,11,11,3,1,10,13,76.9,3,56,48,8,30,45,190,4,Matches
318,Tyrick Mitchell,eng ENG,DF,Crystal Palace,19,1999,2.2,5,2,2,2,1,1,7,14.3,6,2,0,2,2,7,3,0,Matches
319,Henrikh Mkhitaryan,am ARM,FW,Arsenal,30,1989,1.2,0,0,0,0,0,0,2,0.0,2,3,0,3,0,0,1,0,Matches
320,Nacho Monreal,es ESP,DF,Arsenal,33,1986,3.0,1,1,1,0,0,1,3,33.3,2,3,1,2,3,4,10,0,Matches
321,Martín Montoya,es ESP,"DF,MF",Brighton,28,1991,21.1,57,29,31,20,6,30,56,53.6,26,19,5,14,24,81,40,0,Matches
322,Simon Moore,eng ENG,GK,Sheffield Utd,29,1990,2.0,1,0,1,0,0,1,1,100.0,0,0,0,0,0,1,0,1,Matches
323,Aaron Mooy,au AUS,"MF,FW",Brighton,28,1990,23.2,37,24,9,18,10,6,40,15.0,34,36,7,29,23,60,32,1,Matches
324,Wesley Moraes,br BRA,FW,Aston Villa,22,1996,19.8,15,8,3,8,4,0,5,0.0,5,10,2,8,4,19,23,0,Matches
325,Wes Morgan,jm JAM,DF,Leicester City,35,1984,4.8,4,1,3,1,0,0,3,0.0,3,5,3,2,7,11,19,0,Matches
326,Ravel Morrison,jm JAM,MF,Sheffield Utd,26,1993,0.1,0,0,0,0,0,0,0,,0,0,0,0,0,0,0,0,Matches
327,Mason Mount,eng ENG,"MF,FW",Chelsea,20,1999,31.9,37,17,8,19,10,9,42,21.4,33,25,3,22,16,53,18,0,Matches
328,Lucas Moura,br BRA,"FW,MF",Tottenham,26,1992,24.9,57,33,25,22,10,16,58,27.6,42,29,2,27,15,72,27,0,Matches
329,Lys Mousset,fr FRA,FW,Sheffield Utd,23,1996,13.8,9,5,0,5,4,3,7,42.9,4,3,0,3,4,13,2,0,Matches
330,João Moutinho,pt POR,MF,Wolves,32,1986,34.5,93,50,43,41,9,46,139,33.1,93,43,13,30,50,143,18,1,Matches
331,Glenn Murray,eng ENG,FW,Brighton,35,1983,8.9,5,2,0,3,2,2,9,22.2,7,6,2,4,1,6,12,0,Matches
332,Shkodran Mustafi,de GER,DF,Arsenal,27,1992,13.4,17,10,11,5,1,6,12,50.0,6,10,6,4,18,35,72,0,Matches
333,Yoshinori Mutō,jp JPN,"MF,FW",Newcastle Utd,27,1992,2.4,3,2,1,2,0,1,2,50.0,1,0,0,0,0,3,0,0,Matches
334,Georges-Kévin N'Koudou,cm CMR,FW,Tottenham,24,1995,0.0,0,0,0,0,0,0,1,0.0,1,0,0,0,0,0,0,0,Matches
335,Marvelous Nakamba,zw ZIM,MF,Aston Villa,25,1994,20.4,55,28,28,20,7,24,67,35.8,43,50,11,39,39,94,38,3,Matches
336,Wilfred Ndidi,ng NGA,MF,Leicester City,22,1996,29.7,128,67,56,61,11,45,91,49.5,46,52,6,46,80,208,69,3,Matches
337,Tanguy Ndombele,fr FRA,MF,Tottenham,22,1996,11.2,24,16,10,13,1,9,22,40.9,13,20,3,17,14,38,7,0,Matches
338,Reiss Nelson,eng ENG,FW,Arsenal,19,1999,7.0,11,8,5,4,2,7,17,41.2,10,13,2,11,3,14,3,0,Matches
339,Pedro Neto,pt POR,"FW,MF",Wolves,19,2000,10.4,9,4,3,6,0,4,15,26.7,11,2,0,2,6,15,4,0,Matches
340,Rúben Neves,pt POR,MF,Wolves,22,1997,34.0,62,33,27,32,3,34,86,39.5,52,38,9,29,56,118,34,1,Matches
341,Jeremy Ngakia,eng ENG,DF,West Ham,18,2000,4.9,15,7,10,5,0,9,21,42.9,12,6,1,5,7,22,16,0,Matches
342,Oumar Niasse,sn SEN,FW,Everton,29,1990,0.2,4,0,0,2,2,0,0,,0,0,0,0,1,5,0,0,Matches
343,Eddie Nketiah,eng ENG,FW,Arsenal,20,1999,7.0,7,5,3,4,0,2,6,33.3,4,9,0,9,2,9,5,0,Matches
344,Mark Noble,eng ENG,MF,West Ham,32,1987,29.7,52,30,19,28,5,22,64,34.4,42,20,6,14,20,72,10,1,Matches
345,Oliver Norwood,nir NIR,MF,Sheffield Utd,28,1991,34.3,66,37,35,24,7,28,97,28.9,69,34,12,22,47,113,40,1,Matches
346,Ørjan Nyland,no NOR,GK,Aston Villa,28,1990,6.0,0,0,0,0,0,0,0,,0,0,0,0,0,0,1,1,Matches
347,Jack O'Connell,eng ENG,DF,Sheffield Utd,25,1994,32.4,23,14,15,6,2,10,20,50.0,10,38,17,21,42,65,154,1,Matches
348,Michael Obafemi,ie IRL,FW,Southampton,19,2000,7.4,7,3,1,3,3,2,14,14.3,12,3,0,3,6,13,0,0,Matches
349,Angelo Ogbonna,it ITA,DF,West Ham,31,1988,31.0,38,24,20,14,4,18,32,56.3,14,50,32,18,27,65,134,1,Matches
350,Divock Origi,be BEL,FW,Liverpool,24,1995,8.0,12,9,2,5,5,4,9,44.4,5,2,0,2,4,16,5,0,Matches
351,Ben Osborn,eng ENG,"MF,DF",Sheffield Utd,24,1994,6.6,15,10,11,3,1,3,16,18.8,13,6,1,5,6,21,7,0,Matches
352,Nicolás Otamendi,ar ARG,DF,Manchester City,31,1988,19.1,28,14,21,6,1,16,33,48.5,17,15,9,6,21,49,76,2,Matches
353,Alex Oxlade-Chamberlain,eng ENG,"MF,FW",Liverpool,25,1993,16.5,18,9,4,6,8,5,21,23.8,16,26,1,25,22,40,10,0,Matches
354,Mesut Özil,de GER,MF,Arsenal,30,1988,16.0,17,8,9,7,1,4,23,17.4,19,4,0,4,5,22,1,0,Matches
355,Emerson Palmieri,it ITA,DF,Chelsea,24,1994,11.4,23,12,8,11,4,10,15,66.7,5,13,1,12,18,41,19,0,Matches
356,Sokratis Papastathopoulos,gr GRE,DF,Arsenal,31,1988,18.8,25,16,17,7,1,10,21,47.6,11,30,24,6,17,42,68,1,Matches
357,Troy Parrott,ie IRL,FW,Tottenham,17,2002,0.1,0,0,0,0,0,0,0,,0,0,0,0,0,0,0,0,Matches
358,Rui Patrício,pt POR,GK,Wolves,31,1988,38.0,0,0,0,0,0,0,2,0.0,2,2,0,2,2,2,5,2,Matches
359,Pedro,es ESP,"FW,MF",Chelsea,32,1987,7.3,15,7,5,9,1,3,15,20.0,12,9,0,9,9,24,1,0,Matches
360,Nicolas Pépé,ci CIV,FW,Arsenal,24,1995,22.3,32,17,15,13,4,8,16,50.0,8,15,2,13,8,40,5,0,Matches
361,Andreas Pereira,br BRA,"MF,FW",Manchester Utd,23,1996,16.5,24,13,8,9,7,10,39,25.6,29,13,0,13,7,31,7,0,Matches
362,Ricardo Pereira,pt POR,DF,Leicester City,25,1993,28.0,119,68,65,36,18,53,106,50.0,53,38,6,32,49,168,86,0,Matches
363,Roberto Pereyra,ar ARG,"FW,MF",Watford,28,1991,18.3,20,8,11,7,2,9,28,32.1,19,21,0,21,14,34,12,1,Matches
364,Ayoze Pérez,es ESP,"MF,FW",Leicester City,26,1993,22.3,45,28,14,26,5,8,54,14.8,46,33,1,32,14,59,9,1,Matches
365,Jordan Pickford,eng ENG,GK,Everton,25,1994,38.0,0,0,0,0,0,0,4,0.0,4,0,0,0,3,3,12,6,Matches
366,Brandon Pierrick,eng ENG,"MF,FW",Crystal Palace,17,2001,0.2,0,0,0,0,0,0,0,,0,0,0,0,0,0,1,0,Matches
367,Erik Pieters,nl NED,"DF,MF",Burnley,30,1988,20.9,54,32,18,29,7,28,69,40.6,41,30,4,26,28,82,60,1,Matches
368,Daniel Podence,pt POR,"FW,MF",Wolves,23,1995,3.2,3,3,2,0,1,0,2,0.0,2,4,1,3,2,5,1,0,Matches
369,Paul Pogba,fr FRA,MF,Manchester Utd,26,1993,13.4,20,9,8,8,4,8,16,50.0,8,12,4,8,7,27,10,2,Matches
370,Nick Pope,eng ENG,GK,Burnley,27,1992,38.0,1,1,1,0,0,1,2,50.0,1,0,0,0,3,4,15,3,Matches
371,Dennis Praet,be BEL,MF,Leicester City,25,1994,12.6,33,18,8,21,4,9,29,31.0,20,19,1,18,17,50,12,0,Matches
372,Sebastian Prödl,at AUT,DF,Watford,32,1987,0.6,0,0,0,0,0,0,0,,0,0,0,0,0,0,4,0,Matches
373,Davy Pröpper,nl NED,MF,Brighton,27,1991,31.4,64,35,28,28,8,23,74,31.1,51,27,8,19,38,102,36,4,Matches
374,Teemu Pukki,fi FIN,FW,Norwich City,29,1990,32.1,12,6,3,5,4,1,23,4.3,22,13,0,13,6,18,7,0,Matches
375,Christian Pulisic,us USA,FW,Chelsea,20,1998,19.1,23,11,13,4,6,7,24,29.2,17,15,0,15,6,29,11,0,Matches
376,Ignacio Pussetto,ar ARG,"FW,MF",Watford,23,1995,0.8,7,4,4,2,1,3,8,37.5,5,2,1,1,3,10,4,0,Matches
377,Domingos Quina,pt POR,"MF,FW",Watford,19,1999,0.2,2,0,1,1,0,1,2,50.0,1,3,0,3,0,2,0,0,Matches
378,Aaron Ramsdale,eng ENG,GK,Bournemouth,21,1998,37.0,4,3,4,0,0,3,3,100.0,0,0,0,0,0,4,25,1,Matches
379,Darren Randolph,ie IRL,GK,West Ham,32,1987,2.0,0,0,0,0,0,0,0,,0,0,0,0,0,0,2,0,Matches
380,Marcus Rashford,eng ENG,FW,Manchester Utd,21,1997,29.4,13,9,1,6,6,9,23,39.1,14,23,0,23,10,23,19,0,Matches
381,Nathan Redmond,eng ENG,"MF,FW",Southampton,25,1994,30.7,49,29,17,23,9,21,57,36.8,36,39,2,37,16,65,16,0,Matches
382,Pepe Reina,es ESP,GK,Aston Villa,36,1982,12.0,0,0,0,0,0,0,2,0.0,2,0,0,0,0,0,9,1,Matches
383,Declan Rice,eng ENG,MF,West Ham,20,1999,38.0,116,60,64,48,4,47,98,48.0,51,41,9,32,77,193,55,0,Matches
384,Richarlison,br BRA,"FW,MF",Everton,22,1997,34.1,70,47,28,28,14,27,56,48.2,29,34,4,30,12,82,42,0,Matches
385,Diego Rico,es ESP,DF,Bournemouth,26,1993,25.9,61,39,32,24,5,29,59,49.2,30,31,7,24,84,145,91,0,Matches
386,Jaïro Riedewald,nl NED,"DF,MF",Crystal Palace,22,1996,8.5,14,10,4,10,0,7,11,63.6,4,7,2,5,17,31,23,1,Matches
387,Matt Ritchie,sct SCO,"DF,MF",Newcastle Utd,29,1989,14.6,22,15,9,10,3,3,15,20.0,12,20,5,15,14,36,31,1,Matches
388,Roberto,es ESP,GK,West Ham,33,1986,7.6,0,0,0,0,0,0,0,,0,0,0,0,0,0,2,2,Matches
389,Patrick Roberts,eng ENG,"FW,MF",Norwich City,22,1997,0.3,0,0,0,0,0,0,0,,0,0,0,0,0,0,0,0,Matches
390,Andrew Robertson,sct SCO,DF,Liverpool,25,1994,34.6,54,31,17,25,12,27,61,44.3,34,29,7,22,38,92,72,1,Matches
391,Callum Robinson,ie IRL,"FW,MF",Sheffield Utd,24,1995,7.5,6,3,2,2,2,2,7,28.6,5,3,0,3,7,13,3,0,Matches
392,Jack Robinson,eng ENG,DF,Sheffield Utd,25,1993,5.6,10,5,5,5,0,1,6,16.7,5,12,5,7,8,18,24,0,Matches
393,Rodri,es ESP,MF,Manchester City,23,1996,27.6,50,30,17,25,8,23,63,36.5,40,19,5,14,26,76,35,0,Matches
394,Jay Rodriguez,eng ENG,FW,Burnley,30,1989,22.4,29,19,4,13,12,8,33,24.2,25,33,6,27,5,34,12,0,Matches
395,Jack Rodwell,eng ENG,MF,Sheffield Utd,28,1991,0.2,0,0,0,0,0,0,0,,0,0,0,0,0,0,1,0,Matches
396,Marcos Rojo,ar ARG,DF,Manchester Utd,29,1990,1.4,3,1,2,1,0,1,2,50.0,1,2,1,1,0,3,6,0,Matches
397,Oriol Romeu,es ESP,MF,Southampton,27,1991,20.7,55,35,23,30,2,27,75,36.0,48,35,13,22,34,89,32,0,Matches
398,Danny Rose,eng ENG,DF,Tottenham,29,1990,9.9,18,11,6,10,2,9,20,45.0,11,14,6,8,8,26,34,2,Matches
399,Danny Rose,eng ENG,DF,Newcastle Utd,29,1990,9.6,21,12,11,8,2,12,21,57.1,9,11,4,7,10,31,14,1,Matches
400,Antonio Rüdiger,de GER,DF,Chelsea,26,1993,19.0,28,18,19,7,2,16,25,64.0,9,15,9,6,16,44,59,1,Matches
401,Lukas Rupp,de GER,"FW,MF",Norwich City,28,1991,7.7,15,9,7,5,3,5,17,29.4,12,11,0,11,15,30,4,0,Matches
402,Mathew Ryan,au AUS,GK,Brighton,27,1992,38.0,1,1,1,0,0,1,4,25.0,3,0,0,0,2,3,13,2,Matches
403,Allan Saint-Maximin,fr FRA,"MF,FW",Newcastle Utd,22,1997,20.7,13,8,7,4,2,4,18,22.2,14,5,2,3,9,22,6,0,Matches
404,Romain Saïss,ma MAR,DF,Wolves,29,1990,30.1,55,38,37,15,3,32,46,69.6,14,31,16,15,55,110,127,3,Matches
405,Bukayo Saka,eng ENG,"DF,FW",Arsenal,17,2001,19.5,36,21,21,8,7,19,37,51.4,18,12,3,9,12,48,19,0,Matches
406,Mamadou Sakho,fr FRA,DF,Crystal Palace,29,1990,10.3,7,5,5,1,1,2,5,40.0,3,12,5,7,20,27,46,2,Matches
407,Mohamed Salah,eg EGY,FW,Liverpool,27,1992,32.0,16,6,1,4,11,5,22,22.7,17,3,1,2,8,24,2,1,Matches
408,Mbwana Samatta,tz TAN,FW,Aston Villa,26,1992,10.5,6,4,0,3,3,1,8,12.5,7,7,0,7,1,7,6,0,Matches
409,Carlos Sánchez,co COL,MF,West Ham,33,1986,1.3,1,0,0,1,0,1,1,100.0,0,1,0,1,2,3,1,0,Matches
410,Davinson Sánchez,co COL,DF,Tottenham,23,1996,27.0,44,27,32,12,0,22,44,50.0,22,40,28,12,34,78,128,5,Matches
411,Leroy Sané,de GER,FW,Manchester City,23,1996,0.1,0,0,0,0,0,0,0,,0,0,0,0,0,0,0,0,Matches
412,Ismaila Sarr,sn SEN,"FW,MF",Watford,21,1998,22.5,11,10,5,2,4,5,23,21.7,18,9,1,8,18,29,10,0,Matches
413,Fabian Schär,ch SUI,"DF,MF",Newcastle Utd,27,1991,18.6,39,21,25,14,0,19,40,47.5,21,35,18,17,47,86,74,2,Matches
414,Ezequiel Schelotto,it ITA,DF,Brighton,30,1989,4.0,4,3,1,2,1,2,8,25.0,6,3,0,3,7,11,14,0,Matches
415,Jeffrey Schlupp,gh GHA,"FW,MF",Crystal Palace,26,1992,11.5,18,9,10,7,1,6,16,37.5,10,11,3,8,13,31,15,0,Matches
416,Kasper Schmeichel,dk DEN,GK,Leicester City,32,1986,38.0,1,1,1,0,0,1,2,50.0,1,0,0,0,1,2,4,2,Matches
417,Morgan Schneiderlin,fr FRA,MF,Everton,29,1989,11.1,31,22,13,16,2,8,24,33.3,16,13,3,10,21,52,20,1,Matches
418,Ryan Sessegnon,eng ENG,"DF,FW",Tottenham,19,2000,3.8,6,4,2,4,0,3,6,50.0,3,0,0,0,3,9,12,0,Matches
419,Xherdan Shaqiri,ch SUI,"FW,MF",Liverpool,27,1991,2.1,1,0,0,1,0,0,1,0.0,1,0,0,0,0,1,0,0,Matches
420,Billy Sharp,eng ENG,FW,Sheffield Utd,33,1986,11.7,6,5,2,1,3,1,6,16.7,5,2,0,2,1,7,2,0,Matches
421,Luke Shaw,eng ENG,DF,Manchester Utd,24,1995,19.3,34,18,19,11,4,19,33,57.6,14,26,6,20,24,58,56,1,Matches
422,Jonjo Shelvey,eng ENG,MF,Newcastle Utd,27,1992,23.5,29,19,17,12,0,11,42,26.2,31,14,5,9,23,52,38,0,Matches
423,Djibril Sidibé,fr FRA,"DF,MF",Everton,27,1992,20.3,83,44,48,25,10,43,72,59.7,29,19,3,16,40,123,41,0,Matches
424,Gylfi Sigurðsson,is ISL,MF,Everton,29,1989,28.4,50,26,15,24,11,19,70,27.1,51,30,4,26,37,87,17,1,Matches
425,Bernardo Silva,pt POR,"FW,MF",Manchester City,24,1994,22.6,36,18,8,21,7,13,44,29.5,31,25,1,24,24,60,13,0,Matches
426,David Silva,es ESP,MF,Manchester City,33,1986,20.3,26,14,3,15,8,10,28,35.7,18,18,3,15,13,39,5,0,Matches
427,Jack Simpson,eng ENG,DF,Bournemouth,22,1996,2.7,5,2,4,1,0,2,8,25.0,6,1,0,1,2,7,12,1,Matches
428,Moussa Sissoko,fr FRA,MF,Tottenham,29,1989,27.2,39,25,25,12,2,20,48,41.7,28,19,4,15,27,66,43,2,Matches
429,Oliver Skipp,eng ENG,MF,Tottenham,18,2000,0.9,2,2,0,2,0,1,4,25.0,3,3,2,1,0,2,0,0,Matches
430,William Smallbone,ie IRL,MF,Southampton,19,2000,4.4,10,5,2,8,0,5,10,50.0,5,7,1,6,1,11,2,0,Matches
431,Adam Smith,eng ENG,DF,Bournemouth,28,1991,22.8,47,32,29,16,2,23,50,46.0,27,27,6,21,25,72,64,1,Matches
432,Emile Smith Rowe,eng ENG,MF,Arsenal,19,2000,1.1,1,1,1,0,0,1,3,33.3,2,0,0,0,1,2,2,0,Matches
433,Robert Snodgrass,sct SCO,"MF,FW",West Ham,31,1987,16.8,29,16,17,10,2,13,44,29.5,31,12,1,11,4,33,11,0,Matches
434,Cédric Soares,pt POR,"MF,DF",Arsenal,27,1991,2.8,8,6,2,6,0,1,3,33.3,2,3,0,3,3,11,4,0,Matches
435,Cédric Soares,pt POR,DF,Southampton,27,1991,14.5,45,26,19,24,2,25,41,61.0,16,18,4,14,19,64,51,0,Matches
436,Dominic Solanke,eng ENG,FW,Bournemouth,21,1997,18.3,8,4,2,5,1,5,33,15.2,28,9,1,8,8,16,18,1,Matches
437,Tomáš Souček,cz CZE,MF,West Ham,24,1995,11.6,29,15,13,15,1,10,23,43.5,13,7,1,6,22,51,35,0,Matches
438,Çağlar Söyüncü,tr TUR,DF,Leicester City,23,1996,33.7,60,40,41,18,1,27,46,58.7,19,35,19,16,43,103,156,1,Matches
439,Dennis Srbeny,de GER,"MF,FW",Norwich City,25,1994,0.5,5,5,3,2,0,1,3,33.3,2,1,0,1,0,5,1,0,Matches
440,Jack Stacey,eng ENG,DF,Bournemouth,23,1996,17.2,21,11,9,11,1,8,22,36.4,14,27,11,16,18,39,64,1,Matches
441,Junior Stanislas,eng ENG,"MF,FW",Bournemouth,29,1989,7.9,10,7,2,3,5,3,8,37.5,5,6,0,6,4,14,6,0,Matches
442,Jed Steer,eng ENG,GK,Aston Villa,26,1992,0.1,0,0,0,0,0,0,0,,0,0,0,0,0,0,0,0,Matches
443,Dale Stephens,eng ENG,MF,Brighton,30,1989,28.1,73,44,30,37,6,25,75,33.3,50,31,11,20,58,131,42,2,Matches
444,Jack Stephens,eng ENG,DF,Southampton,25,1994,27.2,44,27,30,13,1,24,46,52.2,22,38,22,16,31,75,120,2,Matches
445,Raheem Sterling,eng ENG,FW,Manchester City,24,1994,29.5,27,15,8,10,9,6,28,21.4,22,16,2,14,15,42,4,0,Matches
446,Enda Stevens,ie IRL,DF,Sheffield Utd,29,1990,37.2,81,46,48,26,7,42,96,43.8,54,27,8,19,35,116,71,3,Matches
447,Marco Stiepermann,de GER,MF,Norwich City,28,1991,13.1,20,8,8,9,3,5,21,23.8,16,11,3,8,5,25,16,0,Matches
448,John Stones,eng ENG,DF,Manchester City,25,1994,12.5,16,10,8,7,1,3,5,60.0,2,5,3,2,9,25,32,2,Matches
449,Isaac Success,ng NGA,"FW,MF",Watford,23,1996,0.8,0,0,0,0,0,0,0,,0,0,0,0,1,1,0,0,Matches
450,Ki Sung-yueng,kr KOR,MF,Newcastle Utd,30,1989,1.5,1,1,0,1,0,1,3,33.3,2,1,0,1,3,4,2,0,Matches
451,Andrew Surman,eng ENG,MF,Bournemouth,32,1986,2.6,4,2,2,2,0,1,3,33.3,2,1,0,1,1,5,5,1,Matches
452,Sam Surridge,eng ENG,"FW,MF",Bournemouth,21,1998,0.3,0,0,0,0,0,0,0,,0,1,0,1,1,1,0,0,Matches
453,Japhet Tanganga,eng ENG,DF,Tottenham,20,1999,5.8,17,9,10,6,1,10,17,58.8,7,7,6,1,11,28,31,2,Matches
454,Matt Targett,eng ENG,"DF,MF",Aston Villa,23,1995,25.5,52,29,37,11,4,22,53,41.5,31,28,8,20,56,108,82,0,Matches
455,James Tarkowski,eng ENG,DF,Burnley,26,1992,38.0,66,43,47,19,0,31,54,57.4,23,63,47,16,63,129,204,4,Matches
456,Charlie Taylor,eng ENG,DF,Burnley,25,1993,21.6,39,24,26,9,4,19,39,48.7,20,29,9,20,29,68,78,1,Matches
457,Neil Taylor,wls WAL,DF,Aston Villa,30,1989,12.1,16,11,12,4,0,11,20,55.0,9,15,5,10,20,36,43,0,Matches
458,Nathan Tella,ng NGA,FW,Southampton,20,1999,0.0,0,0,0,0,0,0,0,,0,0,0,0,0,0,0,0,Matches
459,Alexander Tettey,no NOR,"MF,DF",Norwich City,33,1986,26.0,23,18,7,16,0,11,39,28.2,28,20,9,11,43,66,72,1,Matches
460,Jordan Thomas,eng ENG,FW,Norwich City,18,2001,0.0,0,0,0,0,0,0,0,,0,0,0,0,0,0,0,0,Matches
461,Luke Thomas,eng ENG,"MF,DF",Leicester City,18,2001,3.0,1,0,0,1,0,0,3,0.0,3,2,0,2,3,4,7,0,Matches
462,Max Thompson,eng ENG,FW,Burnley,17,2002,0.0,0,0,0,0,0,0,0,,0,0,0,0,0,0,0,0,Matches
463,Youri Tielemans,be BEL,MF,Leicester City,22,1997,31.4,52,29,17,30,5,24,74,32.4,50,43,4,39,22,74,18,0,Matches
464,Kieran Tierney,sct SCO,"DF,MF",Arsenal,22,1997,11.0,20,16,13,6,1,11,15,73.3,4,10,4,6,9,29,37,1,Matches
465,James Tomkins,eng ENG,DF,Crystal Palace,30,1989,17.6,29,17,21,8,0,18,25,72.0,7,17,15,2,21,50,103,0,Matches
466,Fikayo Tomori,eng ENG,DF,Chelsea,21,1997,14.3,29,16,21,8,0,10,15,66.7,5,13,7,6,22,51,48,2,Matches
467,Lucas Torreira,uy URU,MF,Arsenal,23,1996,16.8,31,16,11,15,5,16,39,41.0,23,24,8,16,34,65,24,0,Matches
468,Cenk Tosun,tr TUR,FW,Crystal Palace,28,1991,2.0,2,2,2,0,0,0,2,0.0,2,0,0,0,0,2,1,0,Matches
469,Cenk Tosun,tr TUR,FW,Everton,28,1991,3.2,2,0,0,0,2,0,1,0.0,1,1,0,1,0,2,1,0,Matches
470,Andros Townsend,eng ENG,"FW,MF",Crystal Palace,28,1991,14.4,34,21,12,17,5,15,37,40.5,22,18,0,18,15,49,10,1,Matches
471,Adama Traoré,es ESP,"FW,DF",Wolves,23,1996,28.9,33,21,6,14,13,8,23,34.8,15,19,3,16,13,46,14,2,Matches
472,Mark Travers,ie IRL,GK,Bournemouth,20,1999,1.0,0,0,0,0,0,0,0,,0,0,0,0,0,0,1,1,Matches
473,Trézéguet,eg EGY,"FW,MF",Aston Villa,24,1994,21.7,38,16,18,15,5,9,44,20.5,35,23,2,21,25,63,18,0,Matches
474,Leandro Trossard,be BEL,"FW,MF",Brighton,24,1994,22.3,22,17,7,12,3,6,38,15.8,32,16,1,15,9,31,8,0,Matches
475,Tom Trybull,de GER,MF,Norwich City,26,1993,12.6,39,25,15,18,6,16,60,26.7,44,20,5,15,16,55,35,0,Matches
476,Axel Tuanzebe,cd COD,DF,Manchester Utd,21,1997,2.1,2,2,0,2,0,1,2,50.0,1,1,0,1,5,7,5,1,Matches
477,Yan Valery,tn TUN,DF,Southampton,20,1999,8.7,20,7,9,7,4,11,19,57.9,8,9,1,8,13,33,32,2,Matches
478,Jesús Vallejo,es ESP,DF,Wolves,22,1997,1.8,1,1,1,0,0,1,2,50.0,1,4,3,1,2,3,8,1,Matches
479,Virgil van Dijk,nl NED,DF,Liverpool,28,1991,38.0,23,12,18,5,0,6,13,46.2,7,20,15,5,40,63,166,2,Matches
480,Jamie Vardy,eng ENG,FW,Leicester City,32,1987,33.7,15,12,0,9,6,2,4,50.0,2,22,4,18,2,17,22,0,Matches
481,Indiana Vassilev,us USA,"FW,MF",Aston Villa,18,2001,0.6,0,0,0,0,0,0,0,,0,0,0,0,0,0,0,0,Matches
482,Jan Vertonghen,be BEL,DF,Tottenham,32,1987,18.3,40,24,25,14,1,20,31,64.5,11,18,10,8,33,73,68,0,Matches
483,Jannik Vestergaard,dk DEN,DF,Southampton,26,1992,16.6,19,12,14,5,0,11,28,39.3,17,15,9,6,26,45,99,2,Matches
484,Rúben Vinagre,pt POR,"MF,DF",Wolves,20,1999,7.2,23,13,15,6,2,12,15,80.0,3,7,2,5,11,34,22,0,Matches
485,Jake Vokins,eng ENG,DF,Southampton,19,2000,1.0,2,2,0,0,2,1,1,100.0,0,0,0,0,0,2,1,0,Matches
486,Mario Vrančić,ba BIH,MF,Norwich City,30,1989,7.1,27,16,14,11,2,16,27,59.3,11,9,0,9,10,37,4,2,Matches
487,Matěj Vydra,cz CZE,FW,Burnley,27,1992,9.1,4,3,0,3,1,3,6,50.0,3,7,3,4,1,5,6,0,Matches
488,Theo Walcott,eng ENG,"MF,FW",Everton,30,1989,14.3,13,8,6,5,2,3,15,20.0,12,13,0,13,8,21,1,0,Matches
489,Kyle Walker,eng ENG,DF,Manchester City,29,1990,26.6,28,18,12,15,1,12,29,41.4,17,15,6,9,28,56,42,1,Matches
490,Kyle Walker-Peters,eng ENG,DF,Southampton,22,1997,7.8,13,8,5,6,2,6,16,37.5,10,10,3,7,14,27,21,1,Matches
491,Kyle Walker-Peters,eng ENG,DF,Tottenham,22,1997,2.7,8,5,8,0,0,5,9,55.6,4,4,2,2,3,11,5,1,Matches
492,Aaron Wan-Bissaka,eng ENG,DF,Manchester Utd,21,1997,34.1,129,80,71,50,8,64,86,74.4,22,46,13,33,66,195,83,0,Matches
493,Victor Wanyama,ke KEN,MF,Tottenham,28,1991,0.3,0,0,0,0,0,0,0,,0,0,0,0,0,0,0,0,Matches
494,Joel Ward,eng ENG,DF,Crystal Palace,29,1989,26.5,69,42,48,16,5,39,56,69.6,17,13,6,7,48,117,93,1,Matches
495,James Ward-Prowse,eng ENG,"MF,DF",Southampton,24,1994,38.0,92,48,39,39,14,39,94,41.5,55,48,14,34,60,152,75,1,Matches
496,Kelland Watts,eng ENG,DF,Newcastle Utd,19,1999,0.2,1,0,1,0,0,1,1,100.0,0,0,0,0,0,1,0,0,Matches
497,Adam Webster,eng ENG,DF,Brighton,24,1995,29.6,30,17,21,8,1,14,32,43.8,18,43,26,17,45,75,110,2,Matches
498,Danny Welbeck,eng ENG,"FW,MF",Watford,28,1990,9.1,14,6,6,5,3,3,11,27.3,8,12,1,11,5,19,7,0,Matches
499,Ashley Westwood,eng ENG,MF,Burnley,29,1990,35.0,54,33,15,32,7,17,48,35.4,31,23,11,12,32,86,32,3,Matches
500,Connor Wickham,eng ENG,"FW,MF",Crystal Palace,26,1993,1.1,1,1,1,0,0,0,0,,0,1,0,1,1,2,0,0,Matches
501,Georginio Wijnaldum,nl NED,MF,Liverpool,28,1990,32.6,38,20,12,21,5,10,40,25.0,30,18,4,14,17,55,34,3,Matches
502,Jetro Willems,nl NED,DF,Newcastle Utd,25,1994,16.6,37,19,29,6,2,18,39,46.2,21,20,5,15,17,54,42,1,Matches
503,Brandon Williams,eng ENG,DF,Manchester Utd,18,2000,11.2,21,15,11,6,4,9,29,31.0,20,9,4,5,16,37,27,0,Matches
504,Neco Williams,wls WAL,DF,Liverpool,18,2001,2.6,5,3,1,3,1,4,5,80.0,1,3,1,2,9,14,6,0,Matches
505,Willian,br BRA,"FW,MF",Chelsea,30,1988,28.9,45,27,14,24,7,14,43,32.6,29,15,0,15,20,65,7,0,Matches
506,Joe Willock,eng ENG,"MF,FW",Arsenal,19,1999,9.5,25,16,9,12,4,8,21,38.1,13,16,2,14,4,29,11,2,Matches
507,Jack Wilshere,eng ENG,MF,West Ham,27,1992,2.4,1,0,1,0,0,0,4,0.0,4,3,0,3,1,2,0,0,Matches
508,Callum Wilson,eng ENG,FW,Bournemouth,27,1992,32.3,12,9,3,6,3,2,17,11.8,15,16,2,14,4,16,16,0,Matches
509,Harry Wilson,wls WAL,"MF,FW",Bournemouth,22,1997,18.3,23,13,8,10,5,11,34,32.4,23,26,2,24,11,34,15,1,Matches
510,Harry Winks,eng ENG,MF,Tottenham,23,1996,24.7,40,24,18,20,2,17,54,31.5,37,27,8,19,36,76,32,1,Matches
511,Chris Wood,nz NZL,FW,Burnley,27,1991,27.1,7,4,2,4,1,5,15,33.3,10,15,2,13,4,11,18,0,Matches
512,Granit Xhaka,ch SUI,MF,Arsenal,26,1992,28.7,45,25,20,19,6,25,55,45.5,30,32,16,16,21,66,59,3,Matches
513,Andriy Yarmolenko,ua UKR,"MF,FW",West Ham,29,1989,11.0,13,8,5,6,2,5,20,25.0,15,3,1,2,6,19,4,0,Matches
514,DeAndre Yedlin,us USA,DF,Newcastle Utd,26,1993,10.4,18,13,10,6,2,8,16,50.0,8,13,7,6,10,28,20,0,Matches
515,Maya Yoshida,jp JPN,DF,Southampton,30,1988,6.2,8,5,4,1,3,3,7,42.9,4,6,2,4,4,12,27,1,Matches
516,Ashley Young,eng ENG,DF,Manchester Utd,34,1985,10.6,14,7,7,4,3,5,17,29.4,12,8,2,6,11,25,29,0,Matches
517,Pablo Zabaleta,ar ARG,DF,West Ham,34,1985,6.6,18,10,12,5,1,6,13,46.2,7,5,3,2,14,32,21,0,Matches
518,Wilfried Zaha,ci CIV,"FW,MF",Crystal Palace,26,1992,36.4,43,19,18,12,13,12,49,24.5,37,22,2,20,18,61,4,0,Matches
519,Christoph Zimmermann,de GER,DF,Norwich City,26,1993,15.9,32,21,26,6,0,21,30,70.0,9,22,18,4,19,51,87,2,Matches
520,Oleksandr Zinchenko,ua UKR,DF,Manchester City,22,1996,14.2,31,19,16,11,4,17,32,53.1,15,9,0,9,17,48,21,1,Matches
521,Richairo Živković,cw CUW,FW,Sheffield Utd,22,1996,1.2,2,2,0,2,0,1,2,50.0,1,1,0,1,0,2,0,0,Matches
522,Kurt Zouma,fr FRA,DF,Chelsea,24,1994,26.0,23,14,17,6,0,9,16,56.3,7,22,14,8,58,81,116,2,Matches
1,Max Aarons,eng ENG,DF,Bournemouth,25-037,2000,1.0,2,2,1,1,0,1,1,100.0,0,3,1,2,1,3,0,0,Matches
2,Joshua Acheampong,eng ENG,DF,Chelsea,18-281,2006,1.8,2,1,2,0,0,2,2,100.0,0,1,0,1,1,3,2,0,Matches
3,Tyler Adams,us USA,MF,Bournemouth,25-362,1999,9.6,42,29,15,23,4,16,30,53.3,14,10,3,7,24,66,25,0,Matches
4,Tosin Adarabioyo,eng ENG,DF,Chelsea,27-139,1997,9.1,12,9,9,3,0,7,10,70.0,3,7,6,1,3,15,33,0,Matches
5,Simon Adingra,ci CIV,"FW,MF",Brighton,23-040,2002,6.6,14,7,7,5,2,6,17,35.3,11,6,0,6,6,20,3,1,Matches
6,Emmanuel Agbadou,ci CIV,DF,Wolves,27-238,1997,4.0,14,9,10,4,0,7,11,63.6,4,4,2,2,5,19,23,0,Matches
7,Asher Agbinone,eng ENG,MF,Crystal Palace,19-135,2005,0.1,2,1,0,2,0,0,0,,0,0,0,0,0,2,0,0,Matches
8,Ola Aina,ng NGA,DF,Nott'ham Forest,28-125,1996,23.1,46,35,32,13,1,30,49,61.2,19,22,7,15,29,75,72,1,Matches
9,Rayan Aït-Nouri,dz ALG,DF,Wolves,23-249,2001,21.7,56,34,38,15,3,29,44,65.9,15,29,5,24,16,72,48,1,Matches
10,Kristoffer Ajer,no NOR,DF,Brentford,26-299,1998,8.8,11,8,8,3,0,5,14,35.7,9,9,2,7,6,17,24,0,Matches
11,Manuel Akanji,ch SUI,DF,Manchester City,29-206,1995,19.0,15,10,8,4,3,7,12,58.3,5,11,8,3,7,22,55,3,Matches
12,Nathan Aké,nl NED,DF,Manchester City,29-358,1995,6.7,9,7,7,2,0,4,5,80.0,1,7,2,5,3,12,20,1,Matches
13,Carlos Alcaraz,ar ARG,MF,Southampton,22-072,2002,0.1,0,0,0,0,0,0,0,,0,0,0,0,1,1,0,0,Matches
14,Trent Alexander-Arnold,eng ENG,DF,Liverpool,26-126,1998,19.3,51,38,30,13,8,32,69,46.4,37,22,7,15,25,76,36,2,Matches
15,Alisson,br BRA,GK,Liverpool,32-131,1992,14.9,0,0,0,0,0,0,0,,0,0,0,0,0,0,9,0,Matches
16,Miguel Almirón,py PAR,FW,Newcastle Utd,31-000,1994,1.7,3,2,2,0,1,2,3,66.7,1,2,0,2,0,3,0,0,Matches
17,Edson Álvarez,mx MEX,MF,West Ham,27-109,1997,13.7,34,19,18,10,6,15,30,50.0,15,19,7,12,13,47,29,1,Matches
18,Will Alves,eng ENG,FW,Leicester City,20-007,2005,0.0,0,0,0,0,0,0,0,,0,0,0,0,0,0,0,0,Matches
19,Samuel Amo-Ameyaw,eng ENG,"FW,DF",Southampton,18-207,2006,0.3,1,0,0,1,0,1,1,100.0,0,0,0,0,0,1,0,0,Matches
20,Joachim Andersen,dk DEN,DF,Crystal Palace,28-255,1996,1.0,1,1,1,0,0,1,2,50.0,1,0,0,0,0,1,7,0,Matches
21,Joachim Andersen,dk DEN,DF,Fulham,28-255,1996,14.7,14,11,12,2,0,7,13,53.8,6,13,8,5,18,32,74,0,Matches
22,Elliot Anderson,eng ENG,MF,Nott'ham Forest,22-096,2002,17.2,57,38,35,16,6,32,60,53.3,28,30,5,25,17,74,41,2,Matches
23,André,br BRA,MF,Wolves,23-209,2001,14.6,50,34,24,21,5,21,34,61.8,13,28,7,21,18,68,23,1,Matches
24,Michail Antonio,jm JAM,FW,West Ham,34-319,1990,9.3,2,2,0,1,1,2,3,66.7,1,6,0,6,0,2,2,0,Matches
25,Antony,br BRA,"DF,MF",Manchester Utd,24-352,2000,1.6,6,3,4,2,0,2,5,40.0,3,2,0,2,2,8,0,0,Matches
26,Julian Araujo,mx MEX,DF,Bournemouth,23-181,2001,3.9,7,3,3,4,0,4,10,40.0,6,3,0,3,4,11,13,0,Matches
27,Cameron Archer,eng ENG,FW,Southampton,23-204,2001,11.6,8,5,4,2,2,1,5,20.0,4,5,1,4,2,10,6,0,Matches
28,Alphonse Areola,fr FRA,GK,West Ham,31-349,1993,12.1,1,1,1,0,0,1,2,50.0,1,0,0,0,0,1,7,1,Matches
29,Joe Aribo,ng NGA,MF,Southampton,28-204,1996,16.3,29,19,8,16,5,11,24,45.8,13,21,7,14,13,42,21,2,Matches
30,Adam Armstrong,eng ENG,"FW,MF",Southampton,28-000,1997,13.9,12,3,2,7,3,3,14,21.4,11,6,1,5,3,15,8,0,Matches
31,Harrison Armstrong,eng ENG,MF,Everton,18-022,2007,0.5,0,0,0,0,0,0,1,0.0,1,0,0,0,0,0,1,0,Matches
32,Kepa Arrizabalaga,es ESP,GK,Bournemouth,30-130,1994,17.0,1,0,1,0,0,0,1,0.0,1,1,0,1,0,1,8,2,Matches
33,Brandon Austin,eng ENG,GK,Tottenham,26-033,1999,1.0,0,0,0,0,0,0,0,,0,0,0,0,0,0,1,0,Matches
34,Taiwo Awoniyi,ng NGA,FW,Nott'ham Forest,27-182,1997,2.9,4,2,0,3,1,2,3,66.7,1,1,0,1,0,4,4,0,Matches
35,Yasin Ayari,se SWE,MF,Brighton,21-127,2003,14.1,40,21,11,22,7,17,35,48.6,18,16,5,11,13,53,16,0,Matches
36,Jordan Ayew,gh GHA,"FW,MF",Crystal Palace,33-152,1991,0.2,1,0,0,0,1,0,0,,0,0,0,0,0,1,0,0,Matches
37,Jordan Ayew,gh GHA,"FW,MF",Leicester City,33-152,1991,13.0,20,11,7,11,2,4,14,28.6,10,13,0,13,12,32,11,0,Matches
38,Benoît Badiashile,fr FRA,DF,Chelsea,23-321,2001,2.8,6,4,3,3,0,2,2,100.0,0,2,2,0,6,12,6,1,Matches
39,Leon Bailey,jm JAM,"FW,MF",Aston Villa,27-185,1997,11.5,6,4,1,3,2,2,8,25.0,6,6,0,6,3,9,10,0,Matches
40,Carlos Baleba,cm CMR,MF,Brighton,21-038,2004,16.9,49,26,15,23,11,30,44,68.2,14,26,5,21,31,80,15,0,Matches
41,Ross Barkley,eng ENG,MF,Aston Villa,31-067,1993,6.2,13,3,4,9,0,9,13,69.2,4,9,3,6,9,22,5,0,Matches
42,Harvey Barnes,eng ENG,FW,Newcastle Utd,27-063,1997,8.7,10,6,3,4,3,3,5,60.0,2,4,1,3,4,14,5,1,Matches
43,Calvin Bassey,ng NGA,DF,Fulham,25-041,1999,23.0,34,21,20,14,0,16,20,80.0,4,31,14,17,13,47,72,5,Matches
44,Jan Bednarek,pl POL,DF,Southampton,28-304,1996,19.8,24,12,14,10,0,10,23,43.5,13,33,27,6,40,64,119,4,Matches
45,Jean-Ricner Bellegarde,fr FRA,"MF,FW",Wolves,26-228,1998,10.5,18,10,6,9,3,7,10,70.0,3,14,3,11,10,28,9,1,Matches
46,Rodrigo Bentancur,uy URU,MF,Tottenham,27-230,1997,9.6,26,13,11,13,2,13,21,61.9,8,12,2,10,23,49,17,1,Matches
47,Sander Berge,no NOR,MF,Fulham,26-362,1998,13.6,37,22,15,19,3,19,27,70.4,8,19,6,13,17,54,22,0,Matches
48,Lucas Bergvall,se SWE,MF,Tottenham,19-008,2006,6.7,22,14,9,10,3,12,19,63.2,7,8,6,2,13,35,16,2,Matches
49,Victor Bernth Kristiansen,dk DEN,DF,Leicester City,22-056,2002,20.5,63,38,42,18,3,33,58,56.9,25,30,12,18,30,93,59,3,Matches
50,Beto,gw GNB,FW,Everton,27-010,1998,4.5,7,3,1,2,4,1,2,50.0,1,4,1,3,0,7,4,0,Matches
51,Philip Billing,dk DEN,MF,Bournemouth,28-244,1996,2.0,14,5,7,6,1,3,4,75.0,1,3,0,3,5,19,2,0,Matches
52,Yves Bissouma,ml MLI,MF,Tottenham,28-164,1996,11.5,34,23,14,17,3,16,29,55.2,13,7,4,3,13,47,28,3,Matches
53,Lamare Bogarde,nl NED,"DF,MF",Aston Villa,21-036,2004,3.9,12,6,6,5,1,9,14,64.3,5,3,1,2,1,13,7,0,Matches
54,Willy Boly,ci CIV,DF,Nott'ham Forest,34-007,1991,1.5,5,1,4,1,0,4,4,100.0,0,3,1,2,3,8,12,0,Matches
55,Sven Botman,nl NED,DF,Newcastle Utd,25-029,2000,2.5,5,3,2,3,0,2,3,66.7,1,2,1,1,4,9,12,0,Matches
56,Jarrod Bowen,eng ENG,"FW,MF",West Ham,28-052,1996,19.4,27,17,10,6,11,12,28,42.9,16,12,2,10,13,40,19,0,Matches
57,Conor Bradley,nir NIR,DF,Liverpool,21-216,2003,2.9,4,2,1,2,1,4,11,36.4,7,2,0,2,3,7,14,0,Matches
58,Jarrad Branthwaite,eng ENG,DF,Everton,22-228,2002,14.1,23,12,18,5,0,11,14,78.6,3,15,10,5,16,39,80,2,Matches
59,James Bree,eng ENG,DF,Southampton,27-122,1997,7.4,14,9,5,8,1,6,14,42.9,8,8,3,5,6,20,21,0,Matches
60,Ben Brereton,cl CHI,FW,Southampton,25-298,1999,5.0,3,2,0,2,1,1,9,11.1,8,2,1,1,0,3,4,0,Matches
61,Nathan Broadhead,wls WAL,"FW,MF",Ipswich Town,26-311,1998,4.2,4,2,1,3,0,2,6,33.3,4,2,0,2,3,7,5,0,Matches
62,Armando Broja,al ALB,FW,Everton,23-153,2001,1.8,2,1,1,1,0,0,0,,0,3,0,3,0,2,3,0,Matches
63,David Brooks,wls WAL,FW,Bournemouth,27-217,1997,6.4,7,1,1,4,2,1,8,12.5,7,10,2,8,4,11,6,1,Matches
64,Emi Buendía,ar ARG,"MF,FW",Aston Villa,28-047,1996,1.1,6,6,3,2,1,0,5,0.0,5,5,1,4,0,6,2,0,Matches
65,Santiago Bueno,uy URU,DF,Wolves,26-093,1998,14.8,27,14,18,9,0,13,17,76.5,4,30,17,13,13,40,45,0,Matches
66,Facundo Buonanotte,ar ARG,"FW,MF",Leicester City,20-049,2004,12.7,42,22,14,16,12,18,57,31.6,39,27,6,21,8,50,8,0,Matches
67,Cameron Burgess,au AUS,DF,Ipswich Town,29-112,1995,10.0,9,7,7,2,0,5,5,100.0,0,14,11,3,9,18,67,1,Matches
68,Dan Burn,eng ENG,DF,Newcastle Utd,32-277,1992,23.0,25,14,16,8,1,12,26,46.2,14,22,17,5,15,40,111,1,Matches
69,Wes Burns,wls WAL,"FW,DF",Ipswich Town,30-079,1994,10.3,13,11,1,9,3,4,10,40.0,6,7,2,5,10,23,13,2,Matches
70,Moisés Caicedo,ec ECU,MF,Chelsea,23-100,2001,23.6,71,45,30,34,7,35,56,62.5,21,30,8,22,33,104,36,0,Matches
71,Tom Cairney,sct SCO,MF,Fulham,34-021,1991,4.4,7,2,2,2,3,2,3,66.7,1,3,1,2,4,11,1,1,Matches
72,Jens Cajuste,se SWE,MF,Ipswich Town,25-184,1999,11.6,26,11,11,14,1,10,26,38.5,16,14,4,10,14,40,17,2,Matches
73,Riccardo Calafiori,it ITA,DF,Arsenal,22-267,2002,8.4,24,17,14,9,1,16,23,69.6,7,12,6,6,9,33,21,0,Matches
74,Dominic Calvert-Lewin,eng ENG,FW,Everton,27-331,1997,17.5,9,7,1,4,4,2,6,33.3,4,6,2,4,6,15,18,0,Matches
75,Diego Carlos,br BRA,DF,Aston Villa,31-332,1993,9.2,8,3,6,1,1,4,6,66.7,2,13,7,6,5,13,36,2,Matches
76,Fabio Carvalho,pt POR,"FW,MF",Brentford,22-164,2002,4.8,13,9,4,4,5,6,13,46.2,7,6,1,5,3,16,2,0,Matches
77,Casemiro,br BRA,MF,Manchester Utd,32-353,1992,9.3,39,26,21,11,7,21,40,52.5,19,25,5,20,8,47,30,3,Matches
78,Kaelan Casey,eng ENG,DF,West Ham,20-105,2004,0.0,0,0,0,0,0,0,0,,0,0,0,0,0,0,1,0,Matches
79,Matty Cash,pl POL,DF,Aston Villa,27-187,1997,14.0,38,21,21,15,2,17,27,63.0,10,14,5,9,17,55,34,1,Matches
80,Timothy Castagne,be BEL,DF,Fulham,29-067,1995,10.0,25,13,15,9,1,13,20,65.0,7,9,2,7,12,37,40,0,Matches
81,Trevoh Chalobah,eng ENG,DF,Crystal Palace,25-220,1999,11.8,20,16,7,12,1,12,23,52.2,11,19,9,10,19,39,57,3,Matches
82,Trevoh Chalobah,eng ENG,DF,Chelsea,25-220,1999,2.0,1,1,0,1,0,1,1,100.0,0,1,1,0,4,5,10,0,Matches
83,Conor Chaplin,eng ENG,"MF,FW",Ipswich Town,27-360,1997,6.8,11,5,3,6,2,6,13,46.2,7,8,1,7,3,14,2,0,Matches
84,Federico Chiesa,it ITA,FW,Liverpool,27-108,1997,0.3,0,0,0,0,0,0,1,0.0,1,1,0,1,0,0,0,0,Matches
85,Chiquinho,pt POR,MF,Wolves,25-005,2000,0.1,0,0,0,0,0,0,0,,0,0,0,0,0,0,0,0,Matches
86,Hamza Choudhury,eng ENG,"MF,DF",Leicester City,27-132,1997,1.5,1,1,1,0,0,1,3,33.3,2,4,2,2,5,6,2,0,Matches
87,Ryan Christie,sct SCO,MF,Bournemouth,29-354,1995,19.5,44,28,16,21,7,24,54,44.4,30,36,11,25,24,68,44,3,Matches
88,Harry Clarke,eng ENG,DF,Ipswich Town,23-345,2001,4.2,5,3,3,2,0,3,6,50.0,3,5,4,1,4,9,14,3,Matches
89,Jack Clarke,eng ENG,"FW,MF",Ipswich Town,24-079,2000,6.8,20,11,10,8,2,11,21,52.4,10,4,0,4,4,24,10,1,Matches
90,Nathaniel Clyne,eng ENG,"DF,MF",Crystal Palace,33-311,1991,4.4,11,7,7,3,1,5,7,71.4,2,4,2,2,3,14,12,1,Matches
91,Conor Coady,eng ENG,DF,Leicester City,31-351,1993,8.0,7,4,3,4,0,2,3,66.7,1,15,11,4,7,14,31,1,Matches
92,Séamus Coleman,ie IRL,DF,Everton,36-122,1988,2.2,2,1,1,1,0,2,3,66.7,1,5,3,2,1,3,7,0,Matches
93,Nathan Collins,ie IRL,DF,Brentford,23-286,2001,24.0,27,17,17,8,2,18,24,75.0,6,47,34,13,21,48,133,2,Matches
94,Toby Collyer,eng ENG,MF,Manchester Utd,21-038,2004,1.4,7,6,4,3,0,3,4,75.0,1,1,1,0,0,7,2,0,Matches
95,Levi Colwill,eng ENG,DF,Chelsea,21-350,2003,22.0,26,18,16,8,2,11,17,64.7,6,25,18,7,24,50,70,3,Matches
96,Lewis Cook,eng ENG,"MF,DF",Bournemouth,28-007,1997,21.6,56,31,27,27,2,22,46,47.8,24,20,6,14,28,84,42,0,Matches
97,Maxwel Cornet,ci CIV,FW,Southampton,28-136,1996,0.8,5,5,1,4,0,0,4,0.0,4,0,0,0,0,5,2,0,Matches
98,Vladimír Coufal,cz CZE,DF,West Ham,32-172,1992,8.2,14,9,9,4,1,6,15,40.0,9,11,10,1,6,20,29,1,Matches
99,Woyo Coulibaly,fr FRA,DF,Leicester City,25-266,1999,0.2,2,1,1,1,0,0,0,,0,1,0,1,1,3,0,0,Matches
100,Aaron Cresswell,eng ENG,DF,West Ham,35-057,1989,3.3,3,0,1,2,0,3,3,100.0,0,4,1,3,2,5,11,0,Matches
101,Marc Cucurella,es ESP,DF,Chelsea,26-203,1998,20.0,35,23,21,12,2,16,32,50.0,16,31,8,23,16,51,46,3,Matches
102,Jorge Cuenca,es ESP,DF,Fulham,25-085,1999,1.0,1,1,1,0,0,1,4,25.0,3,0,0,0,1,2,13,0,Matches
103,Matheus Cunha,br BRA,"MF,FW",Wolves,25-259,1999,20.8,30,17,16,12,2,10,31,32.3,21,17,1,16,16,46,20,0,Matches
104,Patson Daka,zm ZAM,"FW,MF",Leicester City,26-124,1998,3.4,8,4,1,4,3,5,9,55.6,4,4,1,3,0,8,6,0,Matches
105,Diogo Dalot,pt POR,DF,Manchester Utd,25-329,1999,22.6,51,32,31,15,5,23,37,62.2,14,17,8,9,30,81,51,0,Matches
106,Mikkel Damsgaard,dk DEN,"MF,FW",Brentford,24-222,2000,19.9,55,32,20,17,18,19,50,38.0,31,23,1,22,20,75,26,1,Matches
107,Danilo,br BRA,MF,Nott'ham Forest,23-287,2001,0.9,1,0,0,1,0,0,2,0.0,2,0,0,0,0,1,2,0,Matches
108,Jayden Danns,eng ENG,MF,Liverpool,19-025,2006,0.1,0,0,0,0,0,0,1,0.0,1,0,0,0,0,0,0,0,Matches
109,Ben Davies,wls WAL,DF,Tottenham,31-292,1993,6.0,4,3,1,3,0,3,8,37.5,5,12,8,4,7,11,36,0,Matches
110,Leif Davis,eng ENG,DF,Ipswich Town,25-029,2000,23.5,38,22,31,4,3,26,43,60.5,17,21,6,15,18,56,61,1,Matches
111,Craig Dawson,eng ENG,DF,Wolves,34-280,1990,10.8,15,3,8,6,1,12,15,80.0,3,16,11,5,9,24,52,1,Matches
112,Kevin De Bruyne,be BEL,MF,Manchester City,33-227,1991,11.2,9,4,4,2,3,3,14,21.4,11,6,0,6,5,14,9,1,Matches
113,Liam Delap,eng ENG,FW,Ipswich Town,22-002,2003,19.6,9,6,3,2,4,1,10,10.0,9,6,0,6,2,11,17,0,Matches
114,Sepp van den Berg,nl NED,DF,Brentford,23-052,2001,18.9,28,17,17,7,4,12,21,57.1,9,38,25,13,14,42,82,2,Matches
115,Justin Devenny,nir NIR,MF,Crystal Palace,21-122,2003,3.0,10,7,6,3,1,7,12,58.3,5,3,0,3,0,10,6,0,Matches
116,Kiernan Dewsbury-Hall,eng ENG,MF,Chelsea,26-157,1998,1.5,2,2,1,0,1,1,2,50.0,1,1,0,1,1,3,4,1,Matches
117,Amad Diallo,ci CIV,"FW,MF",Manchester Utd,22-214,2002,17.7,33,26,6,19,8,15,26,57.7,11,10,0,10,11,44,16,0,Matches
118,Rúben Dias,pt POR,DF,Manchester City,27-272,1997,13.1,9,5,3,5,1,3,6,50.0,3,11,10,1,14,23,33,1,Matches
119,Luis Díaz,co COL,FW,Liverpool,28-028,1997,15.9,17,10,6,10,1,8,19,42.1,11,13,0,13,3,20,6,1,Matches
120,Tyler Dibling,eng ENG,"FW,MF",Southampton,18-335,2006,13.7,21,14,6,12,3,9,15,60.0,6,14,3,11,5,26,8,0,Matches
121,Lucas Digne,fr FRA,DF,Aston Villa,31-205,1993,19.7,48,28,26,14,8,32,47,68.1,15,18,4,14,25,73,67,1,Matches
122,Issa Diop,fr FRA,DF,Fulham,28-032,1997,11.9,21,10,13,8,0,10,14,71.4,4,9,7,2,7,28,51,2,Matches
123,Axel Disasi,fr FRA,DF,Chelsea,26-336,1998,4.0,7,4,5,1,1,6,11,54.5,5,4,1,3,2,9,11,1,Matches
124,Roman Dixon,eng ENG,DF,Everton,20-046,2004,1.0,5,5,3,2,0,4,4,100.0,0,1,0,1,1,6,3,0,Matches
125,Matt Doherty,ie IRL,DF,Wolves,33-025,1992,12.9,23,12,17,6,0,7,13,53.8,6,15,9,6,17,40,50,1,Matches
126,Jeremy Doku,be BEL,"FW,MF",Manchester City,22-259,2002,8.8,20,12,8,7,5,5,8,62.5,3,6,1,5,2,22,2,0,Matches
127,Nicolás Domínguez,ar ARG,"MF,FW",Nott'ham Forest,26-227,1998,12.5,42,21,21,14,7,19,37,51.4,18,25,7,18,21,63,28,1,Matches
128,Alfie Dorrington,eng ENG,DF,Tottenham,19-296,2005,0.2,0,0,0,0,0,0,0,,0,0,0,0,0,0,0,0,Matches
129,Abdoulaye Doucouré,ml MLI,MF,Everton,32-040,1993,18.7,33,19,15,13,5,7,22,31.8,15,22,5,17,6,39,14,1,Matches
130,Cheick Doucouré,ml MLI,MF,Crystal Palace,25-033,2000,5.0,16,8,6,8,2,5,11,45.5,6,4,0,4,11,27,10,1,Matches
131,Flynn Downes,eng ENG,MF,Southampton,26-021,1999,15.9,34,19,17,14,3,11,27,40.7,16,19,4,15,22,56,32,3,Matches
132,Tommy Doyle,eng ENG,MF,Wolves,23-116,2001,5.1,11,6,6,3,2,6,14,42.9,8,10,4,6,5,16,9,1,Matches
133,Radu Drăgușin,ro ROU,DF,Tottenham,23-007,2002,13.9,10,6,8,2,0,6,12,50.0,6,22,16,6,15,25,49,4,Matches
134,Martin Dúbravka,sk SVK,GK,Newcastle Utd,36-026,1989,9.0,0,0,0,0,0,0,0,,0,0,0,0,0,0,2,0,Matches
135,Lewis Dunk,eng ENG,DF,Brighton,33-081,1991,17.4,15,8,7,6,2,9,14,64.3,5,20,14,6,10,25,57,0,Matches
136,Jáder Durán,co COL,FW,Aston Villa,21-059,2003,7.1,8,7,1,2,5,1,4,25.0,3,5,0,5,0,8,13,0,Matches
137,Ederson,br BRA,GK,Manchester City,31-177,1993,15.0,0,0,0,0,0,0,2,0.0,2,0,0,0,1,1,5,1,Matches
138,George Edmundson,eng ENG,DF,Ipswich Town,27-163,1997,0.0,0,0,0,0,0,0,0,,0,0,0,0,0,0,0,0,Matches
139,Odsonne Édouard,fr FRA,"MF,FW",Crystal Palace,27-025,1998,1.3,1,0,0,1,0,0,2,0.0,2,1,0,1,0,1,1,0,Matches
140,Odsonne Édouard,fr FRA,FW,Leicester City,27-025,1998,0.3,1,1,1,0,0,0,0,,0,0,0,0,0,1,1,0,Matches
141,Samuel Edozie,eng ENG,"DF,FW",Southampton,22-013,2003,0.7,3,1,0,1,2,2,2,100.0,0,0,0,0,0,3,0,0,Matches
142,Ronnie Edwards,eng ENG,DF,Southampton,21-319,2003,0.1,0,0,0,0,0,0,0,,0,1,1,0,0,0,0,0,Matches
143,Anthony Elanga,se SWE,"FW,MF",Nott'ham Forest,22-289,2002,16.2,12,8,5,5,2,3,9,33.3,6,6,0,6,5,17,22,0,Matches
144,Harvey Elliott,eng ENG,"MF,FW",Liverpool,21-312,2003,0.9,3,2,2,1,0,0,1,0.0,1,1,0,1,0,3,1,0,Matches
145,Yunus Emre Konak,tr TUR,"MF,FW",Brentford,19-031,2006,0.2,1,1,0,1,0,0,1,0.0,1,0,0,0,0,1,0,0,Matches
146,Julio Enciso,py PAR,MF,Ipswich Town,21-018,2004,1.1,2,1,0,0,2,1,1,100.0,0,0,0,0,1,3,0,0,Matches
147,Julio Enciso,py PAR,"MF,FW",Brighton,21-018,2004,3.3,0,0,0,0,0,0,2,0.0,2,2,0,2,0,0,1,0,Matches
148,Wataru Endo,jp JPN,MF,Liverpool,32-001,1993,1.0,4,3,1,3,0,3,4,75.0,1,2,0,2,2,6,2,0,Matches
149,Christian Eriksen,dk DEN,MF,Manchester Utd,32-362,1992,7.1,12,5,3,7,2,7,12,58.3,5,7,2,5,6,18,6,0,Matches
150,Romain Esse,eng ENG,MF,Crystal Palace,19-273,2005,0.1,1,1,1,0,0,1,1,100.0,0,0,0,0,0,1,0,0,Matches
151,Pervis Estupiñán,ec ECU,DF,Brighton,27-020,1998,15.7,39,27,20,13,6,17,26,65.4,9,9,2,7,18,57,37,0,Matches
152,Evanilson,br BRA,FW,Bournemouth,25-127,1999,15.2,9,4,2,4,3,3,7,42.9,4,7,1,6,0,9,11,0,Matches
153,Jonny Evans,nir NIR,DF,Manchester Utd,37-038,1988,3.2,7,5,4,3,0,2,4,50.0,2,2,1,1,4,11,13,0,Matches
154,Eberechi Eze,eng ENG,"MF,FW",Crystal Palace,26-226,1998,17.9,29,17,11,12,6,15,30,50.0,15,21,0,21,7,36,5,1,Matches
155,Łukasz Fabiański,pl POL,GK,West Ham,39-298,1985,11.9,0,0,0,0,0,0,1,0.0,1,0,0,0,0,0,5,1,Matches
156,Wout Faes,be BEL,DF,Leicester City,26-313,1998,18.3,28,18,18,8,2,13,29,44.8,16,31,21,10,17,45,106,3,Matches
157,Abdul Fatawu Issahaku,gh GHA,FW,Leicester City,20-339,2004,6.4,21,15,13,2,6,11,19,57.9,8,7,0,7,4,25,12,0,Matches
158,João Félix,pt POR,"FW,MF",Chelsea,25-092,1999,4.1,8,3,2,5,1,5,9,55.6,4,2,0,2,3,11,2,0,Matches
159,Evan Ferguson,ie IRL,FW,Brighton,20-114,2004,2.7,4,3,0,3,1,2,5,40.0,3,3,1,2,0,4,4,0,Matches
160,Bruno Fernandes,pt POR,MF,Manchester Utd,30-155,1994,21.4,46,25,10,25,11,17,48,35.4,31,21,2,19,17,63,24,2,Matches
161,Mateus Fernandes,pt POR,MF,Southampton,20-215,2004,19.3,56,31,29,17,10,17,42,40.5,25,29,3,26,13,69,23,4,Matches
162,Enzo Fernández,ar ARG,MF,Chelsea,24-024,2001,18.8,47,23,11,22,14,24,59,40.7,35,24,3,21,9,56,14,3,Matches
163,Mark Flekken,nl NED,GK,Brentford,31-242,1993,22.4,2,2,2,0,0,1,6,16.7,5,1,0,1,0,2,20,3,Matches
164,Phil Foden,eng ENG,"MF,FW",Manchester City,24-258,2000,15.2,9,3,3,3,3,6,16,37.5,10,9,1,8,9,18,6,1,Matches
165,Wesley Fofana,fr FRA,DF,Chelsea,24-055,2000,11.3,13,12,6,7,0,6,14,42.9,8,14,9,5,12,25,49,2,Matches
166,Carlos Forbs,pt POR,"MF,FW",Wolves,20-328,2004,2.6,8,5,5,2,1,4,5,80.0,1,3,0,3,1,9,2,1,Matches
167,Fraser Forster,eng ENG,GK,Tottenham,36-330,1988,7.0,0,0,0,0,0,0,1,0.0,1,0,0,0,0,0,7,3,Matches
168,Ryan Fraser,sct SCO,"FW,DF",Southampton,30-352,1994,3.4,6,2,2,4,0,4,6,66.7,2,1,1,0,1,7,9,0,Matches
169,Niclas Füllkrug,de GER,FW,West Ham,32-001,1993,4.1,2,2,0,1,1,2,3,66.7,1,0,0,0,0,2,5,0,Matches
170,Cody Gakpo,nl NED,FW,Liverpool,25-279,1999,14.5,21,11,4,9,8,10,19,52.6,9,17,2,15,6,27,12,1,Matches
171,Idrissa Gana Gueye,sn SEN,MF,Everton,35-137,1989,19.5,74,44,36,29,9,35,52,67.3,17,29,5,24,27,101,16,0,Matches
172,Andrés García,es ESP,DF,Aston Villa,22-003,2003,0.5,1,0,1,0,0,1,2,50.0,1,0,0,0,0,1,2,1,Matches
173,Alejandro Garnacho,ar ARG,"FW,MF",Manchester Utd,20-224,2004,14.7,15,10,5,4,6,4,17,23.5,13,14,0,14,7,22,9,2,Matches
174,James Garner,eng ENG,"DF,MF",Everton,23-334,2001,3.9,12,9,7,5,0,9,12,75.0,3,3,2,1,5,17,12,0,Matches
175,Tyrique George,eng ENG,FW,Chelsea,19-006,2006,0.1,0,0,0,0,0,0,0,,0,0,0,0,0,0,0,0,Matches
176,Morgan Gibbs-White,eng ENG,MF,Nott'ham Forest,25-014,2000,17.4,29,13,12,13,4,10,16,62.5,6,8,3,5,11,40,15,0,Matches
177,Billy Gilmour,sct SCO,MF,Brighton,23-244,2001,1.1,3,3,2,1,0,3,4,75.0,1,1,0,1,0,3,1,0,Matches
178,Ben Godfrey,eng ENG,DF,Ipswich Town,27-026,1998,0.7,0,0,0,0,0,0,0,,0,0,0,0,0,0,1,0,Matches
179,Martial Godo,eng ENG,FW,Fulham,21-333,2003,0.2,0,0,0,0,0,0,0,,0,1,0,1,1,1,0,0,Matches
180,João Gomes,br BRA,MF,Wolves,23-364,2001,20.6,71,38,36,33,2,27,69,39.1,42,28,2,26,18,89,26,0,Matches
181,Rodrigo Gomes,pt POR,"DF,FW",Wolves,21-218,2003,6.3,19,12,10,9,0,9,17,52.9,8,8,1,7,4,23,17,1,Matches
182,Toti Gomes,pt POR,DF,Wolves,26-025,1999,15.0,33,25,23,9,1,17,20,85.0,3,16,10,6,9,42,70,2,Matches
183,Diego Gómez,py PAR,MF,Brighton,21-320,2003,0.5,4,3,3,0,1,1,2,50.0,1,4,0,4,0,4,0,1,Matches
184,Joe Gomez,eng ENG,DF,Liverpool,27-263,1997,5.8,13,10,5,7,1,11,16,68.8,5,9,6,3,7,20,20,2,Matches
185,Anthony Gordon,eng ENG,FW,Newcastle Utd,23-352,2001,20.6,23,14,7,13,3,7,25,28.0,18,24,2,22,6,29,9,2,Matches
186,Ryan Gravenberch,nl NED,MF,Liverpool,22-270,2002,22.1,45,23,15,21,9,23,37,62.2,14,25,6,19,40,85,33,0,Matches
187,Archie Gray,eng ENG,DF,Tottenham,18-335,2006,10.7,10,4,3,4,3,5,14,35.7,9,12,7,5,8,18,32,2,Matches
188,Jack Grealish,eng ENG,"FW,MF",Manchester City,29-153,1995,6.8,9,5,4,2,3,2,4,50.0,2,10,2,8,2,11,4,1,Matches
189,Jacob Greaves,eng ENG,DF,Ipswich Town,24-151,2000,14.0,23,11,9,13,1,11,17,64.7,6,19,14,5,16,39,82,2,Matches
190,Brajan Gruda,de GER,"FW,MF",Brighton,20-255,2004,4.1,9,4,2,5,2,6,11,54.5,5,7,0,7,2,11,3,0,Matches
191,Albert Grønbaek,dk DEN,MF,Southampton,23-263,2001,0.8,4,1,1,1,2,3,6,50.0,3,1,1,0,0,4,0,0,Matches
192,Gonçalo Guedes,pt POR,"MF,FW",Wolves,28-073,1996,7.7,14,4,2,5,7,3,14,21.4,11,9,0,9,4,18,3,0,Matches
193,Marc Guéhi,eng ENG,DF,Crystal Palace,24-212,2000,23.0,36,19,25,10,1,19,28,67.9,9,44,19,25,14,50,111,1,Matches
194,Luis Guilherme,br BRA,"MF,FW",West Ham,19-001,2006,0.6,1,0,1,0,0,0,0,,0,5,0,5,2,3,1,0,Matches
195,Bruno Guimarães,br BRA,MF,Newcastle Utd,27-086,1997,23.2,52,31,25,19,8,24,47,51.1,23,21,7,14,21,73,27,3,Matches
196,Marc Guiu,es ESP,FW,Chelsea,19-037,2006,0.8,1,1,0,1,0,1,1,100.0,0,0,0,0,0,1,0,0,Matches
197,İlkay Gündoğan,de GER,MF,Manchester City,34-109,1990,14.9,17,10,4,9,4,9,20,45.0,11,8,0,8,12,29,15,0,Matches
198,Malo Gusto,fr FRA,DF,Chelsea,21-267,2003,14.5,33,22,18,13,2,18,33,54.5,15,23,6,17,15,48,30,2,Matches
199,Joško Gvardiol,hr CRO,DF,Manchester City,23-018,2002,22.5,36,23,16,10,10,14,26,53.8,12,27,13,14,25,61,68,5,Matches
200,Erling Haaland,no NOR,FW,Manchester City,24-204,2000,23.6,7,4,2,2,3,1,5,20.0,4,7,1,6,4,11,21,0,Matches
201,Lewis Hall,eng ENG,DF,Newcastle Utd,20-155,2004,21.3,38,28,15,15,8,24,54,44.4,30,30,16,14,16,54,69,2,Matches
202,Ali Al Hamadi,iq IRQ,FW,Ipswich Town,22-346,2002,1.5,1,0,0,0,1,0,2,0.0,2,0,0,0,0,1,2,0,Matches
203,Marcus Harness,eng ENG,MF,Ipswich Town,28-352,1996,0.5,1,0,0,0,1,0,3,0.0,3,2,1,1,0,1,1,0,Matches
204,Jack Harrison,eng ENG,FW,Everton,28-082,1996,11.1,18,12,8,4,6,9,22,40.9,13,6,0,6,5,23,20,2,Matches
205,Taylor Harwood-Bellis,eng ENG,DF,Southampton,23-011,2002,21.1,21,14,10,8,3,14,23,60.9,9,49,30,19,25,46,91,6,Matches
206,Kai Havertz,de GER,"FW,MF",Arsenal,25-244,1999,20.4,16,9,3,6,7,4,15,26.7,11,22,4,18,6,22,31,1,Matches
207,Jan Paul van Hecke,nl NED,DF,Brighton,24-247,2000,20.9,30,19,17,12,1,15,30,50.0,15,27,15,12,18,48,80,2,Matches
208,Hwang Hee-chan,kr KOR,"MF,FW",Wolves,29-015,1996,6.9,6,4,2,1,3,2,6,33.3,4,9,0,9,2,8,11,0,Matches
209,Dean Henderson,eng ENG,GK,Crystal Palace,27-335,1997,24.0,2,1,2,0,0,2,4,50.0,2,0,0,0,0,2,15,0,Matches
210,Rico Henry,eng ENG,DF,Brentford,27-217,1997,0.0,0,0,0,0,0,0,1,0.0,1,0,0,0,1,1,0,0,Matches
211,Mads Hermansen,dk DEN,GK,Leicester City,24-214,2000,16.5,1,1,1,0,0,1,1,100.0,0,1,0,1,0,1,8,2,Matches
212,Son Heung-min,kr KOR,FW,Tottenham,32-217,1992,17.6,15,8,2,8,5,5,20,25.0,15,8,0,8,4,19,14,1,Matches
213,James Hill,eng ENG,"DF,MF",Bournemouth,23-031,2002,2.0,3,2,1,1,1,0,3,0.0,3,1,0,1,4,7,9,0,Matches
214,Jack Hinshelwood,eng ENG,"MF,DF",Brighton,19-305,2005,10.0,14,10,5,6,3,6,12,50.0,6,5,2,3,6,20,14,1,Matches
215,George Hirst,eng ENG,FW,Ipswich Town,25-361,1999,2.4,1,1,1,0,0,0,1,0.0,1,0,0,0,0,1,4,0,Matches
216,Mason Holgate,eng ENG,"FW,DF",Everton,28-111,1996,0.1,0,0,0,0,0,0,0,,0,0,0,0,0,0,0,0,Matches
217,Callum Hudson-Odoi,eng ENG,"FW,MF",Nott'ham Forest,24-095,2000,16.9,15,10,5,6,4,7,12,58.3,5,6,0,6,12,27,5,1,Matches
218,Will Hughes,eng ENG,MF,Crystal Palace,29-299,1995,15.7,50,28,14,25,11,19,47,40.4,28,18,8,10,11,61,13,0,Matches
219,Dean Huijsen,es ESP,DF,Bournemouth,19-302,2005,13.8,23,18,10,12,1,10,16,62.5,6,26,20,6,29,52,83,2,Matches
220,Omari Hutchinson,eng ENG,"MF,FW",Ipswich Town,21-103,2003,20.7,22,9,9,8,5,11,38,28.9,27,19,1,18,7,29,11,1,Matches
221,Rasmus Højlund,dk DEN,FW,Manchester Utd,22-006,2003,12.3,3,1,0,2,1,0,3,0.0,3,2,0,2,1,4,3,0,Matches
222,Igor,br BRA,DF,Brighton,27-003,1998,10.0,4,4,2,1,1,4,10,40.0,6,23,14,9,4,8,39,1,Matches
223,Danny Ings,eng ENG,"FW,MF",West Ham,32-202,1992,3.1,4,2,2,2,0,1,3,33.3,2,5,0,5,1,5,4,0,Matches
224,Tim Iroegbunam,eng ENG,MF,Everton,21-225,2003,4.4,19,10,9,5,5,8,14,57.1,6,7,1,6,9,28,6,1,Matches
225,Andy Irving,sct SCO,MF,West Ham,24-273,2000,1.8,7,4,3,3,1,1,5,20.0,4,5,1,4,1,8,5,0,Matches
226,Alexander Isak,se SWE,FW,Newcastle Utd,25-142,1999,20.0,10,3,1,3,6,5,10,50.0,5,13,1,12,1,11,11,1,Matches
227,Alex Iwobi,ng NGA,"FW,MF",Fulham,28-283,1996,22.4,28,16,11,14,3,10,19,52.6,9,15,1,14,8,36,23,0,Matches
228,Nicolas Jackson,sn SEN,FW,Chelsea,23-235,2001,19.3,17,10,4,5,8,2,7,28.6,5,12,2,10,2,19,15,0,Matches
229,Reece James,eng ENG,DF,Chelsea,25-064,1999,5.4,7,7,4,3,0,3,8,37.5,5,8,4,4,5,12,9,1,Matches
230,Vitaly Janelt,de GER,MF,Brentford,26-276,1998,19.1,29,17,11,11,7,17,29,58.6,12,23,7,16,19,48,42,1,Matches
231,Vitezslav Jaros,cz CZE,GK,Liverpool,23-202,2001,0.1,0,0,0,0,0,0,0,,0,0,0,0,0,0,0,0,Matches
232,Daniel Jebbison,eng ENG,"FW,MF",Bournemouth,21-181,2003,0.7,0,0,0,0,0,0,1,0.0,1,1,1,0,1,1,1,0,Matches
233,Mathias Jensen,dk DEN,MF,Brentford,29-040,1996,7.8,9,8,6,2,1,4,10,40.0,6,10,2,8,6,15,9,1,Matches
234,Gabriel Jesus,br BRA,FW,Arsenal,27-313,1997,6.8,10,6,4,3,3,4,9,44.4,5,10,1,9,4,14,8,0,Matches
235,Raúl Jiménez,mx MEX,FW,Fulham,33-281,1991,16.9,19,11,3,11,5,3,11,27.3,8,14,4,10,9,28,11,3,Matches
236,Kim Jisoo,kr KOR,DF,Brentford,20-048,2004,0.3,0,0,0,0,0,0,0,,0,0,0,0,0,0,2,0,Matches
237,João Pedro,br BRA,"FW,MF",Brighton,23-137,2001,14.9,10,6,3,5,2,2,8,25.0,6,7,0,7,6,16,8,0,Matches
238,Joelinton,br BRA,"MF,FW",Newcastle Utd,28-180,1996,21.3,47,27,18,21,8,19,36,52.8,17,32,6,26,20,67,40,1,Matches
239,Ben Johnson,eng ENG,"DF,FW",Ipswich Town,25-017,2000,9.2,25,15,16,8,1,14,29,48.3,15,12,4,8,11,36,27,0,Matches
240,Brennan Johnson,wls WAL,FW,Tottenham,23-263,2001,16.6,32,20,5,19,8,12,25,48.0,13,15,2,13,4,36,9,0,Matches
241,Sam Johnstone,eng ENG,GK,Wolves,31-322,1993,7.0,0,0,0,0,0,0,1,0.0,1,0,0,0,0,0,7,0,Matches
242,Curtis Jones,eng ENG,MF,Liverpool,24-011,2001,10.3,22,11,2,16,4,8,13,61.5,5,8,4,4,3,25,6,1,Matches
243,Jorginho,it ITA,MF,Arsenal,33-052,1991,5.1,10,3,1,7,2,6,14,42.9,8,0,0,0,5,15,1,2,Matches
244,Diogo Jota,pt POR,FW,Liverpool,28-068,1996,7.0,6,4,0,4,2,4,12,33.3,8,4,0,4,4,10,5,0,Matches
245,James Justin,eng ENG,DF,Leicester City,26-353,1998,22.0,38,24,20,14,4,21,40,52.5,19,30,8,22,33,71,96,2,Matches
246,Filip Jørgensen,dk DEN,GK,Chelsea,22-300,2002,3.0,0,0,0,0,0,0,0,,0,0,0,0,0,0,0,1,Matches
247,Ferdi Kadioglu,tr TUR,"DF,MF",Brighton,25-126,1999,4.3,10,6,4,5,1,6,15,40.0,9,2,2,0,8,18,17,0,Matches
248,Daichi Kamada,jp JPN,MF,Crystal Palace,28-189,1996,10.4,30,15,9,18,3,8,26,30.8,18,13,3,10,13,43,8,0,Matches
249,Boubacar Kamara,fr FRA,MF,Aston Villa,25-079,1999,11.5,40,15,23,13,4,25,43,58.1,18,12,5,7,13,53,32,3,Matches
250,Michael Kayode,it ITA,DF,Brentford,20-215,2004,0.2,0,0,0,0,0,0,0,,0,0,0,0,0,0,0,0,Matches
251,Michael Keane,eng ENG,DF,Everton,32-030,1993,9.0,10,7,7,2,1,7,10,70.0,3,9,6,3,10,20,50,0,Matches
252,Caoimhín Kelleher,ie IRL,GK,Liverpool,26-079,1998,8.0,0,0,0,0,0,0,0,,0,0,0,0,0,0,0,2,Matches
253,Lloyd Kelly,eng ENG,DF,Newcastle Utd,26-127,1998,3.4,5,4,4,1,0,1,1,100.0,0,6,4,2,1,6,17,0,Matches
254,Milos Kerkez,hu HUN,DF,Bournemouth,21-095,2003,23.2,33,18,16,14,3,16,27,59.3,11,21,8,13,30,63,67,1,Matches
255,Bilal El Khannouss,ma MAR,MF,Leicester City,20-276,2004,12.2,29,15,8,17,4,7,12,58.3,5,13,3,10,4,33,4,0,Matches
256,Abdukodir Khusanov,uz UZB,DF,Manchester City,20-347,2004,0.6,0,0,0,0,0,0,0,,0,1,1,0,0,0,1,1,Matches
257,Max Kilman,eng ENG,DF,West Ham,27-263,1997,23.2,22,11,9,10,3,15,19,78.9,4,38,25,13,28,50,124,4,Matches
258,Joshua King,eng ENG,"MF,FW",Fulham,18-038,2007,0.9,5,3,2,3,0,0,2,0.0,2,2,0,2,1,6,1,0,Matches
259,Antonín Kinský,cz CZE,GK,Tottenham,21-334,2003,4.0,3,1,3,0,0,1,1,100.0,0,0,0,0,0,3,5,1,Matches
260,Jakub Kiwior,pl POL,DF,Arsenal,24-361,2000,3.6,4,2,3,1,0,3,5,60.0,2,5,2,3,1,5,16,1,Matches
261,Justin Kluivert,nl NED,"MF,FW",Bournemouth,25-281,1999,17.0,17,8,3,9,5,3,12,25.0,9,18,0,18,11,28,19,1,Matches
262,Ibrahima Konaté,fr FRA,DF,Liverpool,25-261,1999,15.5,23,15,17,5,1,15,22,68.2,7,17,9,8,8,31,69,1,Matches
263,Ezri Konsa,eng ENG,DF,Aston Villa,27-110,1997,21.1,28,16,17,7,4,16,20,80.0,4,12,6,6,16,44,71,2,Matches
264,Mateo Kovačić,hr CRO,MF,Manchester City,30-280,1994,17.2,46,27,13,26,7,22,48,45.8,26,15,0,15,13,59,16,0,Matches
265,Caleb Kporha,eng ENG,DF,Crystal Palace,18-210,2006,0.1,2,1,2,0,0,2,2,100.0,0,0,0,0,0,2,1,0,Matches
266,Emil Krafth,se SWE,DF,Newcastle Utd,30-192,1994,2.7,2,1,0,1,1,1,2,50.0,1,5,4,1,2,4,10,0,Matches
267,Mohammed Kudus,gh GHA,"MF,FW",West Ham,24-192,2000,17.4,26,17,6,13,7,7,20,35.0,13,21,1,20,3,29,4,1,Matches
268,Dejan Kulusevski,se SWE,"MF,FW",Tottenham,24-291,2000,21.7,34,19,11,10,13,14,41,34.1,27,24,3,21,10,44,8,1,Matches
269,Maxence Lacroix,fr FRA,DF,Crystal Palace,24-310,2000,21.0,44,27,33,10,1,24,35,68.6,11,28,9,19,40,84,121,1,Matches
270,Adam Lallana,eng ENG,MF,Southampton,36-276,1988,3.8,7,5,4,3,0,2,11,18.2,9,4,1,3,4,11,5,0,Matches
271,Tariq Lamptey,gh GHA,DF,Brighton,24-133,2000,5.8,8,6,4,4,0,3,15,20.0,12,10,3,7,4,12,14,1,Matches
272,Will Lankshear,eng ENG,"FW,MF",Tottenham,19-296,2005,0.1,0,0,0,0,0,0,0,,0,0,0,0,0,0,0,0,Matches
273,Roméo Lavia,be BEL,MF,Chelsea,21-035,2004,5.9,17,10,5,9,3,7,14,50.0,7,6,0,6,11,28,5,0,Matches
274,Mario Lemina,ga GAB,"MF,DF",Wolves,31-162,1993,15.2,51,31,27,19,5,20,29,69.0,9,12,7,5,27,78,50,3,Matches
275,Bernd Leno,de GER,GK,Fulham,32-343,1992,24.0,2,2,2,0,0,2,2,100.0,0,1,0,1,0,2,6,4,Matches
276,Jefferson Lerma,co COL,MF,Crystal Palace,30-108,1994,14.4,16,5,7,8,1,8,17,47.1,9,24,13,11,23,39,31,0,Matches
277,Rico Lewis,eng ENG,"DF,MF",Manchester City,20-081,2004,15.6,25,15,11,10,4,10,15,66.7,5,20,4,16,11,36,31,1,Matches
278,Keane Lewis-Potter,eng ENG,"DF,FW",Brentford,23-354,2001,21.3,33,19,18,11,4,21,30,70.0,9,17,7,10,9,42,44,1,Matches
279,Myles Lewis-Skelly,eng ENG,DF,Arsenal,18-137,2006,6.1,18,13,9,9,0,8,8,100.0,0,0,0,0,5,23,8,0,Matches
280,Matthijs de Ligt,nl NED,DF,Manchester Utd,25-182,1999,17.2,17,11,10,6,1,13,21,61.9,8,19,14,5,26,43,52,0,Matches
281,Pedro Lima,br BRA,DF,Wolves,18-224,2006,0.6,1,0,0,0,1,1,2,50.0,1,0,0,0,1,2,4,0,Matches
282,Victor Lindelöf,se SWE,"DF,MF",Manchester Utd,30-208,1994,0.7,3,0,3,0,0,1,1,100.0,0,1,0,1,2,5,4,0,Matches
283,Jesper Lindstrøm,dk DEN,FW,Everton,24-347,2000,9.7,32,18,19,12,1,15,44,34.1,29,12,3,9,10,42,13,0,Matches
284,Valentino Livramento,eng ENG,DF,Newcastle Utd,22-090,2002,18.3,32,22,21,9,2,20,32,62.5,12,20,7,13,19,51,65,1,Matches
285,Sean Longstaff,eng ENG,MF,Newcastle Utd,27-103,1997,8.0,27,16,10,9,8,18,26,69.2,8,13,2,11,5,32,4,0,Matches
286,Saša Lukić,rs SRB,MF,Fulham,28-181,1996,16.7,47,23,14,30,3,13,38,34.2,25,15,5,10,18,65,21,0,Matches
287,Joe Lumley,eng ENG,GK,Southampton,29-361,1995,3.0,0,0,0,0,0,0,0,,0,0,0,0,0,0,3,3,Matches
288,Massimo Luongo,au AUS,MF,Ipswich Town,32-138,1992,1.9,8,5,6,1,1,4,7,57.1,3,4,2,2,2,10,2,0,Matches
289,Ian Maatsen,nl NED,DF,Aston Villa,22-337,2002,5.1,12,7,6,5,1,5,10,50.0,5,4,0,4,6,18,14,1,Matches
290,Alexis Mac Allister,ar ARG,MF,Liverpool,26-048,1998,18.1,60,37,16,37,7,33,64,51.6,31,43,2,41,13,73,14,1,Matches
291,James Maddison,eng ENG,MF,Tottenham,28-079,1996,14.4,21,12,5,10,6,8,24,33.3,16,12,3,9,11,32,15,0,Matches
292,Noni Madueke,eng ENG,FW,Chelsea,22-337,2002,15.9,15,11,6,8,1,10,28,35.7,18,11,0,11,7,22,8,0,Matches
293,Gabriel Magalhães,br BRA,DF,Arsenal,27-053,1997,21.1,20,12,10,7,3,10,14,71.4,4,36,26,10,11,31,72,2,Matches
294,Edmond-Paris Maghoma,eng ENG,MF,Brentford,23-278,2001,0.9,2,1,0,2,0,1,3,33.3,2,1,1,0,1,3,1,0,Matches
295,Harry Maguire,eng ENG,DF,Manchester Utd,31-342,1993,12.1,17,9,12,4,1,8,11,72.7,3,9,7,2,31,48,47,1,Matches
296,Kobbie Mainoo,eng ENG,MF,Manchester Utd,19-297,2005,14.3,37,24,15,11,11,20,33,60.6,13,15,2,13,17,54,6,1,Matches
297,Tyrell Malacia,nl NED,DF,Manchester Utd,25-177,1999,1.1,2,1,2,0,0,1,2,50.0,1,0,0,0,1,3,1,1,Matches
298,Donyell Malen,nl NED,FW,Aston Villa,26-032,1999,0.8,1,1,1,0,0,0,0,,0,0,0,0,0,1,0,0,Matches
299,Orel Mangala,be BEL,MF,Everton,26-329,1998,14.0,16,8,3,11,2,5,8,62.5,3,8,3,5,21,37,24,1,Matches
300,Ryan Manning,ie IRL,DF,Southampton,28-241,1996,8.5,20,14,11,7,2,10,17,58.8,7,13,8,5,8,28,17,0,Matches
301,Solly March,eng ENG,"MF,DF",Brighton,30-205,1994,0.3,4,2,2,1,1,3,3,100.0,0,1,0,1,1,5,0,0,Matches
302,Omar Marmoush,eg EGY,"FW,MF",Manchester City,26-003,1999,1.6,3,2,2,0,1,3,4,75.0,1,4,0,4,0,3,0,0,Matches
303,Gabriel Martinelli,br BRA,"FW,MF",Arsenal,23-237,2001,16.2,16,13,6,4,6,6,20,30.0,14,8,0,8,2,18,13,0,Matches
304,Emiliano Martínez,ar ARG,GK,Aston Villa,32-161,1992,23.5,1,1,1,0,0,0,0,,0,0,0,0,0,1,12,6,Matches
305,Lisandro Martínez,ar ARG,DF,Manchester Utd,27-023,1998,19.5,40,24,25,12,3,21,36,58.3,15,22,8,14,32,72,57,1,Matches
306,Pape Matar Sarr,sn SEN,MF,Tottenham,22-149,2002,13.9,34,24,15,17,2,7,17,41.2,10,19,6,13,19,53,16,1,Matches
307,Jean-Philippe Mateta,fr FRA,FW,Crystal Palace,27-227,1997,20.7,11,7,3,6,2,2,12,16.7,10,11,3,8,2,13,17,0,Matches
308,Stephy Mavididi,eng ENG,FW,Leicester City,26-255,1998,14.3,27,15,14,9,4,10,31,32.3,21,21,2,19,9,36,11,0,Matches
309,Konstantinos Mavropanos,gr GRE,DF,West Ham,27-061,1997,15.6,26,20,18,7,1,11,22,50.0,11,19,14,5,32,58,76,1,Matches
310,Noussair Mazraoui,ma MAR,DF,Manchester Utd,27-088,1997,20.4,70,41,33,26,11,36,58,62.1,22,21,4,17,23,93,54,0,Matches
311,Bryan Mbeumo,cm CMR,FW,Brentford,25-187,1999,23.9,30,17,12,9,9,11,17,64.7,6,18,3,15,11,41,37,0,Matches
312,James Mcatee,eng ENG,"MF,FW",Manchester City,22-115,2002,1.0,2,1,0,2,0,0,2,0.0,2,4,0,4,1,3,0,0,Matches
313,Kasey McAteer,ie IRL,"FW,MF",Leicester City,23-080,2001,4.3,11,8,6,4,1,6,14,42.9,8,8,1,7,2,13,10,0,Matches
314,Alex McCarthy,eng ENG,GK,Southampton,35-069,1989,5.0,0,0,0,0,0,0,0,,0,0,0,0,0,0,1,4,Matches
315,John McGinn,sct SCO,"MF,FW",Aston Villa,30-115,1994,15.1,16,11,4,9,3,5,12,41.7,7,10,0,10,5,21,4,1,Matches
316,Dwight McNeil,eng ENG,"MF,FW",Everton,25-080,1999,12.7,10,6,5,3,2,7,16,43.8,9,7,0,7,5,15,1,1,Matches
317,Scott McTominay,sct SCO,MF,Manchester Utd,28-064,1996,0.2,0,0,0,0,0,0,1,0.0,1,0,0,0,0,0,1,0,Matches
318,Ben Mee,eng ENG,DF,Brentford,35-142,1989,2.0,2,2,0,2,0,1,1,100.0,0,3,3,0,4,6,7,0,Matches
319,Jayden Meghoma,eng ENG,DF,Brentford,18-227,2006,0.1,0,0,0,0,0,0,0,,0,0,0,0,0,0,0,0,Matches
320,Mikel Merino,es ESP,MF,Arsenal,28-233,1996,8.5,21,12,5,10,6,7,18,38.9,11,14,5,9,12,33,13,1,Matches
321,Nikola Milenković,rs SRB,DF,Nott'ham Forest,27-121,1997,23.0,27,18,19,8,0,12,16,75.0,4,29,16,13,16,43,111,0,Matches
322,Lewis Miley,eng ENG,MF,Newcastle Utd,18-285,2006,0.4,2,2,1,1,0,1,2,50.0,1,1,0,1,0,2,1,0,Matches
323,James Milner,eng ENG,MF,Brighton,39-037,1986,1.9,5,2,1,3,1,3,3,100.0,0,4,2,2,2,7,2,1,Matches
324,Tyrone Mings,eng ENG,DF,Aston Villa,31-334,1993,5.2,4,4,3,1,0,1,1,100.0,0,5,4,1,2,6,32,0,Matches
325,Yankuba Minteh,gm GAM,"FW,MF",Brighton,20-203,2004,9.3,17,12,7,3,7,5,16,31.3,11,13,0,13,5,22,9,0,Matches
326,Tyrick Mitchell,eng ENG,DF,Crystal Palace,25-162,1999,23.2,62,41,40,18,4,16,32,50.0,16,51,9,42,8,70,68,1,Matches
327,Kaoru Mitoma,jp JPN,"FW,MF",Brighton,27-266,1997,21.0,30,19,9,12,9,14,38,36.8,24,34,2,32,11,41,5,0,Matches
328,Jakub Moder,pl POL,MF,Brighton,25-309,1999,0.1,1,0,1,0,0,0,2,0.0,2,0,0,0,0,1,3,0,Matches
329,Mikey Moore,eng ENG,"FW,MF",Tottenham,17-183,2007,2.1,0,0,0,0,0,0,1,0.0,1,1,0,1,1,1,1,0,Matches
330,Morato,br BRA,DF,Nott'ham Forest,23-225,2001,5.9,14,10,12,1,1,7,12,58.3,5,8,4,4,7,21,56,2,Matches
331,Álex Moreno,es ESP,DF,Nott'ham Forest,31-247,1993,9.0,24,18,19,5,0,14,34,41.2,20,11,5,6,14,38,33,0,Matches
332,Sam Morsy,eg EGY,MF,Ipswich Town,33-153,1991,21.1,49,26,25,20,4,20,50,40.0,30,22,8,14,21,70,36,4,Matches
333,Yerson Mosquera,co COL,DF,Wolves,23-284,2001,4.9,11,7,9,2,0,9,14,64.3,5,13,10,3,10,21,14,0,Matches
334,Mason Mount,eng ENG,"MF,FW",Manchester Utd,26-031,1999,2.7,6,2,3,3,0,5,7,71.4,2,4,1,3,0,6,0,0,Matches
335,Divin Mubama,eng ENG,FW,Manchester City,20-108,2004,0.3,0,0,0,0,0,0,0,,0,0,0,0,0,0,0,0,Matches
336,Mykhailo Mudryk,ua UKR,FW,Chelsea,24-036,2001,1.7,2,2,2,0,0,0,0,,0,3,1,2,0,2,1,0,Matches
337,Rodrigo Muniz,br BRA,FW,Fulham,23-282,2001,7.5,5,2,1,2,2,3,3,100.0,0,8,1,7,4,9,9,0,Matches
338,Daniel Muñoz,co COL,DF,Crystal Palace,28-260,1996,22.0,86,58,42,27,17,36,64,56.3,28,23,2,21,25,111,60,1,Matches
339,Arijanet Muric,xk KVX,GK,Ipswich Town,26-095,1998,18.0,0,0,0,0,0,0,2,0.0,2,0,0,0,0,0,10,5,Matches
340,Murillo,br BRA,DF,Nott'ham Forest,22-221,2002,22.5,38,27,27,8,3,20,34,58.8,14,50,31,19,24,62,147,2,Matches
341,Jacob Murphy,eng ENG,FW,Newcastle Utd,29-352,1995,14.9,14,11,4,5,5,11,20,55.0,9,19,0,19,9,23,15,0,Matches
342,Vitaliy Mykolenko,ua UKR,DF,Everton,25-257,1999,20.2,39,23,23,10,6,21,38,55.3,17,13,7,6,24,63,86,1,Matches
343,Iliman Ndiaye,sn SEN,FW,Everton,24-341,2000,20.6,43,21,18,12,13,17,42,40.5,25,21,4,17,17,60,19,1,Matches
344,Wilfred Ndidi,ng NGA,MF,Leicester City,28-056,1996,13.5,48,28,26,19,3,15,33,45.5,18,32,12,20,9,57,47,0,Matches
345,Kosta Nedeljković,rs SRB,DF,Aston Villa,19-056,2005,1.4,7,5,1,3,3,2,3,66.7,1,1,0,1,0,7,3,0,Matches
346,Reiss Nelson,eng ENG,FW,Arsenal,25-062,1999,0.0,1,0,0,1,0,0,1,0.0,1,0,0,0,0,1,1,0,Matches
347,Reiss Nelson,eng ENG,FW,Fulham,25-062,1999,5.4,8,6,3,3,2,5,13,38.5,8,11,0,11,5,13,2,0,Matches
348,Neto,br BRA,GK,Bournemouth,35-206,1989,2.0,0,0,0,0,0,0,0,,0,0,0,0,0,0,1,1,Matches
349,Pedro Neto,pt POR,FW,Chelsea,24-338,2000,12.6,13,7,5,6,2,5,14,35.7,9,7,0,7,7,20,3,0,Matches
350,Eddie Nketiah,eng ENG,"MF,FW",Crystal Palace,25-256,1999,7.0,12,5,6,2,4,5,11,45.5,6,6,0,6,2,14,6,0,Matches
351,Christopher Nkunku,fr FRA,FW,Chelsea,27-088,1997,5.1,4,4,0,1,3,2,2,100.0,0,6,2,4,4,8,7,0,Matches
352,Matheus Nunes,pt POR,"DF,MF",Manchester City,26-167,1998,9.9,25,16,10,9,6,12,23,52.2,11,11,3,8,9,34,21,0,Matches
353,Darwin Núñez,uy URU,FW,Liverpool,25-231,1999,9.2,16,14,9,3,4,5,12,41.7,7,5,0,5,1,17,9,0,Matches
354,Ethan Nwaneri,eng ENG,"MF,FW",Arsenal,17-326,2007,3.2,4,2,2,1,1,1,7,14.3,6,5,1,4,0,4,1,0,Matches
355,Christian Nørgaard,dk DEN,MF,Brentford,30-337,1994,18.8,58,37,24,29,5,34,55,61.8,21,28,10,18,32,90,42,1,Matches
356,Jake O'Brien,ie IRL,DF,Everton,23-271,2001,3.5,7,6,6,1,0,4,5,80.0,1,4,1,3,1,8,22,0,Matches
357,Matt O'Riley,dk DEN,MF,Brighton,24-081,2000,5.2,8,7,1,6,1,2,8,25.0,6,4,1,3,11,19,4,1,Matches
358,Dara O'Shea,ie IRL,DF,Ipswich Town,25-343,1999,20.7,30,19,19,9,2,12,16,75.0,4,36,28,8,23,53,120,3,Matches
359,Wilson Odobert,fr FRA,FW,Tottenham,20-074,2004,1.8,5,2,2,2,1,4,6,66.7,2,1,0,1,0,5,1,1,Matches
360,Chiedozie Ogbene,ie IRL,FW,Ipswich Town,27-285,1997,2.6,7,3,1,2,4,2,4,50.0,2,1,0,1,1,8,3,0,Matches
361,Caleb Okoli,it ITA,DF,Leicester City,23-212,2001,9.2,22,13,7,13,2,10,13,76.9,3,21,12,9,12,34,59,2,Matches
362,Robin Olsen,se SWE,GK,Aston Villa,35-033,1990,0.5,1,0,1,0,0,1,1,100.0,0,0,0,0,0,1,1,0,Matches
363,Amadou Onana,be BEL,MF,Aston Villa,23-178,2001,12.0,38,22,18,17,3,11,21,52.4,10,13,6,7,19,57,26,3,Matches
364,André Onana,cm CMR,GK,Manchester Utd,28-314,1996,24.0,1,1,1,0,0,1,3,33.3,2,0,0,0,0,1,9,4,Matches
365,Paul Onuachu,ng NGA,FW,Southampton,30-258,1994,6.0,4,1,1,3,0,2,3,66.7,1,3,1,2,1,5,10,0,Matches
366,Frank Onyeka,ng NGA,MF,Brentford,27-040,1998,0.3,0,0,0,0,0,0,0,,0,0,0,0,0,0,0,0,Matches
367,Lewis Orford,eng ENG,MF,West Ham,18-358,2006,0.5,0,0,0,0,0,0,0,,0,1,0,1,1,1,0,0,Matches
368,Stefan Ortega,de GER,GK,Manchester City,32-096,1992,9.0,0,0,0,0,0,0,1,0.0,1,0,0,0,0,0,8,1,Matches
369,William Osula,dk DEN,"FW,MF",Newcastle Utd,21-190,2003,0.5,1,0,0,0,1,0,1,0.0,1,0,0,0,1,2,0,0,Matches
370,Dango Ouattara,bf BFA,FW,Bournemouth,22-365,2002,13.8,27,23,10,9,8,14,30,46.7,16,23,7,16,7,34,35,0,Matches
371,Nico O’Reilly,eng ENG,MF,Manchester City,19-326,2005,0.2,1,0,0,1,0,0,0,,0,0,0,0,0,1,1,0,Matches
372,Cole Palmer,eng ENG,MF,Chelsea,22-280,2002,23.3,18,10,9,5,4,7,18,38.9,11,13,1,12,5,23,9,1,Matches
373,Emerson Palmieri,it ITA,DF,West Ham,30-191,1994,18.1,49,26,31,15,3,20,35,57.1,15,25,6,19,16,65,40,0,Matches
374,Lucas Paquetá,br BRA,"MF,FW",West Ham,27-167,1997,17.9,48,30,18,21,9,19,35,54.3,16,22,2,20,12,60,23,3,Matches
375,Thomas Partey,gh GHA,"MF,DF",Arsenal,31-242,1993,20.6,64,40,20,27,17,37,57,64.9,20,14,6,8,26,90,36,4,Matches
376,Nathan Patterson,sct SCO,"DF,FW",Everton,23-117,2001,1.4,3,1,1,2,0,1,4,25.0,3,2,0,2,0,3,3,0,Matches
377,Andreas Pereira,br BRA,MF,Fulham,29-040,1996,14.2,13,5,4,6,3,6,27,22.2,21,8,1,7,6,19,7,1,Matches
378,Ricardo Pereira,pt POR,DF,Leicester City,31-127,1993,1.6,3,2,0,1,2,1,4,25.0,3,3,1,2,1,4,0,0,Matches
379,Kalvin Phillips,eng ENG,MF,Ipswich Town,29-070,1995,9.6,23,12,5,14,4,9,27,33.3,18,23,5,18,16,39,24,1,Matches
380,Jaden Philogene Bidace,eng ENG,"FW,MF",Aston Villa,23-002,2002,3.7,11,5,4,7,0,4,6,66.7,2,5,0,5,3,14,2,1,Matches
381,Jaden Philogene Bidace,eng ENG,"FW,MF",Ipswich Town,23-002,2002,1.5,3,2,1,2,0,1,4,25.0,3,3,0,3,3,6,0,0,Matches
382,Jordan Pickford,eng ENG,GK,Everton,30-340,1994,23.0,1,0,1,0,0,1,2,50.0,1,0,0,0,1,2,21,1,Matches
383,Ethan Pinnock,jm JAM,DF,Brentford,31-257,1993,16.0,29,16,14,12,3,12,17,70.6,5,25,16,9,18,47,105,3,Matches
384,Daniel Podence,pt POR,"MF,FW",Wolves,29-112,1995,0.5,0,0,0,0,0,0,1,0.0,1,0,0,0,0,0,0,0,Matches
385,Alfie Pond,eng ENG,DF,Wolves,20-346,2004,0.0,0,0,0,0,0,0,0,,0,0,0,0,0,0,0,0,Matches
386,Nick Pope,eng ENG,GK,Newcastle Utd,32-297,1992,15.0,0,0,0,0,0,0,0,,0,1,0,1,1,1,16,4,Matches
387,Pedro Porro,es ESP,DF,Tottenham,25-150,1999,22.1,49,36,24,16,9,35,61,57.4,26,34,13,21,25,74,67,1,Matches
388,Jarell Quansah,eng ENG,DF,Liverpool,22-012,2003,2.5,9,7,7,2,0,4,5,80.0,1,3,3,0,3,12,10,0,Matches
389,Hákon Rafn Valdimarsson,is ISL,GK,Brentford,23-120,2001,1.6,0,0,0,0,0,0,0,,0,0,0,0,0,0,2,0,Matches
390,Aaron Ramsdale,eng ENG,GK,Southampton,26-272,1998,16.0,0,0,0,0,0,0,1,0.0,1,0,0,0,2,2,8,2,Matches
391,Jacob Ramsey,eng ENG,"FW,MF",Aston Villa,23-258,2001,11.1,17,9,9,6,2,7,11,63.6,4,11,3,8,7,24,5,0,Matches
392,Marcus Rashford,eng ENG,"FW,MF",Manchester Utd,27-102,1997,10.9,7,4,2,2,3,3,9,33.3,6,8,0,8,4,11,7,0,Matches
393,David Raya,es ESP,GK,Arsenal,29-148,1995,24.0,0,0,0,0,0,0,1,0.0,1,0,0,0,1,1,12,4,Matches
394,Harrison Reed,eng ENG,MF,Fulham,30-014,1995,0.7,5,2,2,2,1,0,2,0.0,2,1,0,1,1,6,2,0,Matches
395,Remy Rees-Dottin,eng ENG,FW,Bournemouth,18-341,2006,0.0,0,0,0,0,0,0,0,,0,0,0,0,0,0,0,0,Matches
396,Sergio Reguilón,es ESP,DF,Tottenham,28-056,1996,1.4,4,3,1,3,0,2,3,66.7,1,4,0,4,2,6,3,0,Matches
397,Bobby Reid,jm JAM,"FW,MF",Leicester City,32-008,1993,4.9,5,3,1,4,0,3,8,37.5,5,6,1,5,0,5,4,0,Matches
398,Chadi Riad,ma MAR,DF,Crystal Palace,21-238,2003,1.0,5,2,2,2,1,2,3,66.7,1,0,0,0,2,7,0,0,Matches
399,Declan Rice,eng ENG,MF,Arsenal,26-027,1999,19.3,34,15,11,17,6,11,25,44.0,14,16,9,7,16,50,25,0,Matches
400,Chris Richards,us USA,DF,Crystal Palace,24-319,2000,10.9,25,16,15,8,2,14,23,60.9,9,20,6,14,9,34,58,0,Matches
401,Richarlison,br BRA,FW,Tottenham,27-276,1997,3.1,4,3,0,3,1,0,0,,0,1,1,0,0,4,8,0,Matches
402,Andrew Robertson,sct SCO,DF,Liverpool,30-336,1994,18.3,28,17,16,9,3,21,33,63.6,12,8,4,4,11,39,33,1,Matches
403,Antonee Robinson,us USA,DF,Fulham,27-186,1997,24.0,64,42,41,20,3,30,60,50.0,30,28,4,24,45,109,78,0,Matches
404,Rodri,es ESP,MF,Manchester City,28-233,1996,0.7,2,1,1,1,0,0,0,,0,1,0,1,1,3,0,0,Matches
405,Guido Rodríguez,ar ARG,MF,West Ham,30-304,1994,11.3,30,16,19,11,0,14,30,46.7,16,21,9,12,12,42,28,1,Matches
406,Mads Roerslev,dk DEN,DF,Brentford,25-231,1999,12.2,18,8,14,3,1,11,28,39.3,17,12,5,7,4,22,35,0,Matches
407,Morgan Rogers,eng ENG,"MF,FW",Aston Villa,22-199,2002,21.1,22,11,5,10,7,9,24,37.5,15,15,3,12,4,26,14,1,Matches
408,Cristian Romero,ar ARG,DF,Tottenham,26-289,1998,10.8,27,23,22,5,0,15,22,68.2,7,13,3,10,13,40,32,0,Matches
409,Georginio Rutter,fr FRA,"FW,MF",Brighton,22-296,2002,14.1,26,10,9,11,6,10,28,35.7,18,17,2,15,7,33,12,1,Matches
410,José Sá,pt POR,GK,Wolves,32-024,1993,17.0,2,2,2,0,0,2,2,100.0,0,0,0,0,0,2,7,1,Matches
411,Bukayo Saka,eng ENG,"FW,MF",Arsenal,23-158,2001,14.1,22,13,5,10,7,9,19,47.4,10,16,0,16,2,24,7,0,Matches
412,Mohamed Salah,eg EGY,FW,Liverpool,32-240,1992,22.5,13,8,4,5,4,4,8,50.0,4,3,0,3,4,17,5,0,Matches
413,William Saliba,fr FRA,DF,Arsenal,23-323,2001,21.3,45,27,27,17,1,16,21,76.2,5,14,7,7,14,59,64,3,Matches
414,Robert Sánchez,es ESP,GK,Chelsea,27-084,1997,21.0,0,0,0,0,0,0,1,0.0,1,0,0,0,2,2,15,7,Matches
415,Jadon Sancho,eng ENG,FW,Chelsea,24-322,2000,12.4,7,5,1,2,4,4,9,44.4,5,4,0,4,1,8,4,1,Matches
416,Ibrahim Sangaré,ci CIV,MF,Nott'ham Forest,27-070,1997,2.5,15,9,5,10,0,4,10,40.0,6,5,0,5,2,17,2,0,Matches
417,Pablo Sarabia,es ESP,"MF,FW",Wolves,32-275,1992,4.7,11,6,4,6,1,6,10,60.0,4,5,0,5,4,15,5,1,Matches
418,Jeremy Sarmiento,ec ECU,MF,Brighton,22-239,2002,0.1,0,0,0,0,0,0,0,,0,0,0,0,0,0,0,0,Matches
419,Ismaila Sarr,sn SEN,"MF,FW",Crystal Palace,26-351,1998,17.7,16,8,6,7,3,5,15,33.3,10,16,5,11,6,22,20,0,Matches
420,Sávio,br BRA,"FW,MF",Manchester City,20-306,2004,13.0,16,10,3,8,5,3,10,30.0,7,9,2,7,4,20,5,1,Matches
421,Oliver Scarles,eng ENG,DF,West Ham,19-060,2005,1.3,3,2,3,0,0,3,4,75.0,1,6,1,5,1,4,7,0,Matches
422,Dane Scarlett,eng ENG,FW,Tottenham,20-323,2004,0.1,0,0,0,0,0,0,0,,0,0,0,0,0,0,0,0,Matches
423,Kevin Schade,de GER,FW,Brentford,23-075,2001,12.9,23,17,10,7,6,9,14,64.3,5,8,1,7,3,26,15,0,Matches
424,Fabian Schär,ch SUI,DF,Newcastle Utd,33-052,1991,18.8,19,13,8,11,0,5,16,31.3,11,25,15,10,27,46,73,2,Matches
425,Jeffrey Schlupp,gh GHA,"MF,DF",Crystal Palace,32-049,1992,1.1,2,0,1,0,1,0,3,0.0,3,6,0,6,0,2,2,0,Matches
426,Alex Scott,eng ENG,MF,Bournemouth,21-173,2003,2.9,16,7,8,4,4,12,16,75.0,4,9,1,8,6,22,5,0,Matches
427,Matz Sels,be BEL,GK,Nott'ham Forest,32-350,1992,24.0,1,1,1,0,0,1,1,100.0,0,0,0,0,0,1,15,1,Matches
428,Nélson Semedo,pt POR,DF,Wolves,31-086,1993,18.9,41,24,25,10,6,21,37,56.8,16,23,10,13,7,48,77,1,Matches
429,Antoine Semenyo,gh GHA,FW,Bournemouth,25-034,2000,22.4,35,20,13,17,5,9,30,30.0,21,44,7,37,5,40,24,0,Matches
430,Marcos Senesi,ar ARG,DF,Bournemouth,27-276,1997,10.2,33,21,21,10,2,13,26,50.0,13,14,6,8,11,44,42,0,Matches
431,Ryan Sessegnon,eng ENG,"MF,FW",Fulham,24-268,2000,0.2,0,0,0,0,0,0,2,0.0,2,0,0,0,1,1,2,0,Matches
432,Luke Shaw,eng ENG,DF,Manchester Utd,29-213,1995,0.8,2,2,1,1,0,1,1,100.0,0,1,0,1,1,3,1,0,Matches
433,Zain Silcott-Duberry,ms MSR,FW,Bournemouth,19-216,2005,0.0,1,1,0,0,1,1,1,100.0,0,0,0,0,0,1,0,0,Matches
434,Bernardo Silva,pt POR,"MF,FW",Manchester City,30-184,1994,21.3,32,24,10,17,5,18,38,47.4,20,22,5,17,16,48,17,3,Matches
435,Jota Silva,pt POR,"FW,MF",Nott'ham Forest,25-193,1999,7.9,22,11,11,9,2,4,24,16.7,20,9,1,8,12,34,15,0,Matches
436,Eric da Silva Moreira,de GER,"MF,DF",Nott'ham Forest,18-283,2006,0.3,2,2,2,0,0,2,6,33.3,4,0,0,0,1,3,0,0,Matches
437,Jahmai Simpson-Pusey,eng ENG,DF,Manchester City,19-098,2005,1.1,1,0,1,0,0,0,1,0.0,1,1,1,0,0,1,2,0,Matches
438,Luis Sinisterra,co COL,"FW,MF",Bournemouth,25-238,1999,2.3,5,1,1,2,2,0,4,0.0,4,3,0,3,0,5,5,0,Matches
439,Oliver Skipp,eng ENG,MF,Leicester City,24-147,2000,8.5,14,4,4,9,1,6,9,66.7,3,14,3,11,8,22,10,1,Matches
440,William Smallbone,ie IRL,MF,Southampton,24-355,2000,3.6,8,3,4,3,1,4,9,44.4,5,4,0,4,0,8,3,1,Matches
441,Adam Smith,eng ENG,DF,Bournemouth,33-287,1991,11.5,16,8,8,4,4,9,19,47.4,10,9,2,7,11,27,37,1,Matches
442,Emile Smith Rowe,eng ENG,MF,Fulham,24-197,2000,15.9,26,14,6,11,9,7,18,38.9,11,14,1,13,8,34,10,0,Matches
443,Dominic Solanke,eng ENG,FW,Tottenham,27-149,1997,17.8,15,9,1,10,4,3,9,33.3,6,13,4,9,0,15,18,0,Matches
444,Carlos Soler,es ESP,"MF,FW",West Ham,28-039,1997,11.0,11,10,6,5,0,5,19,26.3,14,13,3,10,5,16,11,2,Matches
445,Ramón Sosa,py PAR,"FW,MF",Nott'ham Forest,25-163,1999,2.7,4,2,2,0,2,1,3,33.3,2,7,0,7,3,7,4,0,Matches
446,Tomáš Souček,cz CZE,MF,West Ham,29-349,1995,18.9,28,14,12,13,3,15,28,53.6,13,24,11,13,13,41,56,0,Matches
447,Boubakary Soumaré,fr FRA,MF,Leicester City,25-349,1999,13.3,25,13,15,9,1,14,22,63.6,8,9,3,6,16,41,16,1,Matches
448,Djed Spence,eng ENG,DF,Tottenham,24-185,2000,7.6,26,22,17,6,3,15,18,83.3,3,14,5,9,9,35,22,1,Matches
449,Jay Stansfield,eng ENG,MF,Fulham,22-078,2002,0.0,0,0,0,0,0,0,0,,0,0,0,0,0,0,0,0,Matches
450,Jason Steele,eng ENG,GK,Brighton,34-176,1990,2.0,0,0,0,0,0,0,0,,0,0,0,0,0,0,1,0,Matches
451,Jack Stephens,eng ENG,DF,Southampton,31-014,1994,8.9,15,10,12,3,0,6,16,37.5,10,8,6,2,5,20,33,2,Matches
452,Raheem Sterling,eng ENG,"FW,MF",Arsenal,30-064,1994,2.4,6,4,0,2,4,3,5,60.0,2,1,0,1,1,7,2,0,Matches
453,Ross Stewart,sct SCO,"FW,MF",Southampton,28-214,1996,1.5,0,0,0,0,0,0,3,0.0,3,3,0,3,0,0,4,0,Matches
454,Jakub Stolarczyk,pl POL,GK,Leicester City,24-053,2000,6.0,2,1,2,0,0,1,2,50.0,1,0,0,0,0,2,5,0,Matches
455,John Stones,eng ENG,"DF,MF",Manchester City,30-258,1994,5.1,5,2,2,2,1,4,4,100.0,0,4,2,2,3,8,14,1,Matches
456,Jørgen Strand Larsen,no NOR,FW,Wolves,25-004,2000,20.4,6,4,2,2,2,2,19,10.5,17,16,3,13,4,10,19,0,Matches
457,Yukinari Sugawara,jp JPN,DF,Southampton,24-227,2000,13.0,24,13,11,12,1,15,24,62.5,9,17,7,10,10,34,38,3,Matches
458,Kamaldeen Sulemana,gh GHA,"FW,MF",Southampton,22-361,2002,3.4,8,7,3,2,3,5,6,83.3,1,2,0,2,3,11,1,0,Matches
459,Crysencio Summerville,nl NED,"FW,MF",West Ham,23-103,2001,8.7,13,7,2,8,3,3,9,33.3,6,13,4,9,0,13,7,0,Matches
460,Sammie Szmodics,ie IRL,"FW,MF",Ipswich Town,29-139,1995,10.9,14,9,3,9,2,5,22,22.7,17,10,2,8,6,20,14,0,Matches
461,Dominik Szoboszlai,hu HUN,MF,Liverpool,24-108,2000,16.2,17,9,7,6,4,10,22,45.5,12,25,2,23,8,25,8,0,Matches
462,Matt Targett,eng ENG,DF,Newcastle Utd,29-145,1995,0.1,0,0,0,0,0,0,1,0.0,1,0,0,0,1,1,1,0,Matches
463,James Tarkowski,eng ENG,DF,Everton,32-083,1992,22.9,51,31,30,18,3,21,33,63.6,12,43,32,11,26,77,146,3,Matches
464,Marcus Tavernier,eng ENG,"FW,MF",Bournemouth,25-325,1999,13.1,33,19,9,15,9,7,19,36.8,12,8,0,8,3,36,9,0,Matches
465,Charlie Taylor,eng ENG,DF,Southampton,31-145,1993,3.0,7,5,4,3,0,5,6,83.3,1,5,3,2,3,10,22,1,Matches
466,Jack Taylor,ie IRL,MF,Ipswich Town,26-232,1998,4.6,9,3,3,5,1,5,12,41.7,7,3,1,2,4,13,13,0,Matches
467,Kenny Tete,nl NED,DF,Fulham,29-124,1995,14.0,41,27,20,12,9,17,28,60.7,11,19,6,13,28,69,36,0,Matches
468,Thiago,br BRA,FW,Brentford,23-229,2001,1.5,2,2,1,0,1,0,1,0.0,1,0,0,0,2,4,2,1,Matches
469,Luke Thomas,eng ENG,DF,Leicester City,23-245,2001,2.0,5,5,5,0,0,3,5,60.0,2,4,1,3,2,7,3,0,Matches
470,Youri Tielemans,be BEL,MF,Aston Villa,27-279,1997,22.7,57,40,22,31,4,23,50,46.0,27,23,8,15,18,75,27,3,Matches
471,Kieran Tierney,sct SCO,"FW,DF",Arsenal,27-250,1997,0.2,0,0,0,0,0,0,1,0.0,1,0,0,0,0,0,0,0,Matches
472,Jurriën Timber,nl NED,DF,Arsenal,23-238,2001,19.5,38,24,7,22,9,11,19,57.9,8,14,4,10,14,52,33,1,Matches
473,Jean-Clair Todibo,fr FRA,DF,West Ham,25-042,1999,9.6,22,15,17,5,0,14,17,82.4,3,15,8,7,11,33,47,3,Matches
474,Harry Toffolo,eng ENG,DF,Nott'ham Forest,29-175,1995,0.5,2,0,1,0,1,0,0,,0,0,0,0,1,3,7,0,Matches
475,Takehiro Tomiyasu,jp JPN,DF,Arsenal,26-097,1998,0.1,0,0,0,0,0,0,0,,0,0,0,0,0,0,1,0,Matches
476,Sandro Tonali,it ITA,MF,Newcastle Utd,24-278,2000,16.2,31,20,12,16,3,12,28,42.9,16,20,9,11,22,53,17,1,Matches
477,Pau Torres,es ESP,DF,Aston Villa,28-025,1997,17.2,18,13,11,6,1,9,14,64.3,5,13,9,4,6,24,49,2,Matches
478,Conor Townsend,eng ENG,"DF,MF",Ipswich Town,31-343,1993,0.5,3,3,3,0,0,1,3,33.3,2,0,0,0,1,4,1,0,Matches
479,Adama Traoré,es ESP,FW,Fulham,29-016,1996,12.6,10,6,6,2,2,4,10,40.0,6,5,0,5,1,11,4,1,Matches
480,Mark Travers,ie IRL,GK,Bournemouth,25-268,1999,5.0,0,0,0,0,0,0,0,,0,0,0,0,0,0,5,0,Matches
481,Ryan Trevitt,eng ENG,MF,Brentford,21-335,2003,0.0,1,1,1,0,0,0,0,,0,0,0,0,0,1,0,0,Matches
482,Kieran Trippier,eng ENG,DF,Newcastle Utd,34-144,1990,6.0,15,8,7,6,2,7,17,41.2,10,3,1,2,6,21,15,0,Matches
483,Leandro Trossard,be BEL,FW,Arsenal,30-068,1994,16.1,20,13,5,12,3,7,22,31.8,15,19,0,19,9,29,16,0,Matches
484,Kostas Tsimikas,gr GRE,DF,Liverpool,28-274,1996,3.8,13,7,8,3,2,6,9,66.7,3,4,2,2,4,17,12,0,Matches
485,Axel Tuanzebe,cd COD,DF,Ipswich Town,27-088,1997,10.9,24,13,15,3,6,13,19,68.4,6,9,4,5,12,36,34,0,Matches
486,Destiny Udogie,it ITA,DF,Tottenham,22-074,2002,15.9,50,31,26,17,7,23,34,67.6,11,27,2,25,17,67,25,1,Matches
487,Manuel Ugarte Ribeiro,uy URU,MF,Manchester Utd,23-305,2001,12.0,54,32,23,25,6,19,43,44.2,24,16,3,13,17,71,12,1,Matches
488,Lesley Ugochukwu,fr FRA,MF,Southampton,20-321,2004,8.3,32,16,9,20,3,10,23,43.5,13,16,5,11,4,36,12,1,Matches
489,Enes Ünal,tr TUR,"FW,MF",Bournemouth,27-276,1997,3.8,1,0,0,0,1,0,3,0.0,3,1,0,1,0,1,6,0,Matches
490,Virgil van Dijk,nl NED,DF,Liverpool,33-217,1991,23.0,25,13,11,12,2,8,14,57.1,6,15,6,9,36,61,99,2,Matches
491,Jamie Vardy,eng ENG,FW,Leicester City,38-030,1987,19.7,9,8,4,3,2,2,7,28.6,5,7,4,3,3,12,15,0,Matches
492,Renato Veiga,pt POR,"DF,MF",Chelsea,21-196,2003,2.0,9,6,6,3,0,4,12,33.3,8,3,1,2,1,10,2,0,Matches
493,Joël Veltman,nl NED,DF,Brighton,33-026,1992,17.3,42,28,23,16,3,30,51,58.8,21,21,7,14,17,59,59,0,Matches
494,Micky van de Ven,nl NED,DF,Tottenham,23-297,2001,8.8,8,5,3,4,1,6,11,54.5,5,8,5,3,9,17,29,1,Matches
495,Bart Verbruggen,nl NED,GK,Brighton,22-176,2002,22.0,0,0,0,0,0,0,2,0.0,2,0,0,0,0,0,14,4,Matches
496,Jannik Vestergaard,dk DEN,DF,Leicester City,32-191,1992,14.0,20,9,15,5,0,7,13,53.8,6,18,11,7,15,35,68,1,Matches
497,Guglielmo Vicario,it ITA,GK,Tottenham,28-126,1996,12.0,0,0,0,0,0,0,0,,0,0,0,0,1,1,7,2,Matches
498,Carlos Vinícius,br BRA,MF,Fulham,29-322,1995,0.0,0,0,0,0,0,0,0,,0,0,0,0,0,0,0,0,Matches
499,Kyle Walker,eng ENG,DF,Manchester City,34-258,1990,10.8,17,10,7,7,3,14,26,53.8,12,13,4,9,3,20,13,1,Matches
500,Kyle Walker-Peters,eng ENG,DF,Southampton,27-303,1997,21.8,32,20,18,9,5,11,24,45.8,13,20,11,9,13,45,58,1,Matches
501,Christian Walton,eng ENG,GK,Ipswich Town,29-093,1995,6.0,0,0,0,0,0,0,1,0.0,1,0,0,0,0,0,1,1,Matches
502,Aaron Wan-Bissaka,eng ENG,DF,West Ham,27-076,1997,22.0,41,31,20,18,3,13,18,72.2,5,23,7,16,43,84,75,0,Matches
503,Danny Ward,wls WAL,GK,Leicester City,31-233,1993,1.5,0,0,0,0,0,0,0,,0,0,0,0,0,0,1,0,Matches
504,James Ward-Prowse,eng ENG,MF,West Ham,30-101,1994,0.2,1,0,1,0,0,1,1,100.0,0,1,0,1,0,1,0,0,Matches
505,James Ward-Prowse,eng ENG,MF,Nott'ham Forest,30-101,1994,4.4,4,1,1,3,0,2,2,100.0,0,3,2,1,5,9,8,0,Matches
506,Ollie Watkins,eng ENG,FW,Aston Villa,29-042,1995,18.2,5,3,0,3,2,1,6,16.7,5,11,3,8,4,9,8,1,Matches
507,Adam Webster,eng ENG,DF,Brighton,30-037,1995,1.9,3,2,2,1,0,1,5,20.0,4,5,3,2,2,5,6,1,Matches
508,Danny Welbeck,eng ENG,FW,Brighton,34-076,1990,15.1,14,8,3,10,1,3,11,27.3,8,12,1,11,5,19,9,0,Matches
509,Welington,br BRA,DF,Southampton,23-357,2001,0.9,6,1,5,1,0,4,6,66.7,2,1,0,1,2,8,2,0,Matches
510,Timo Werner,de GER,"FW,MF",Tottenham,28-341,1996,5.6,6,4,3,3,0,3,13,23.1,10,10,1,9,1,7,7,0,Matches
511,Adam Wharton,eng ENG,MF,Crystal Palace,20-253,2004,6.9,20,10,10,10,0,11,28,39.3,17,6,0,6,11,31,13,0,Matches
512,Ben White,eng ENG,DF,Arsenal,27-125,1997,7.7,10,6,8,1,1,9,21,42.9,12,6,5,1,11,21,23,0,Matches
513,Mats Wieffer,nl NED,MF,Brighton,25-086,1999,5.2,20,11,4,13,3,7,14,50.0,7,10,1,9,7,27,11,2,Matches
514,Neco Williams,wls WAL,DF,Nott'ham Forest,23-303,2001,14.8,43,24,34,7,2,22,41,53.7,19,25,5,20,18,61,63,0,Matches
515,Joe Willock,eng ENG,"MF,FW",Newcastle Utd,25-174,1999,6.9,16,11,8,5,3,12,20,60.0,8,12,1,11,3,19,5,0,Matches
516,Callum Wilson,eng ENG,"FW,MF",Newcastle Utd,32-349,1992,0.7,1,1,0,1,0,0,0,,0,0,0,0,0,1,0,0,Matches
517,Harry Wilson,wls WAL,"FW,MF",Fulham,27-325,1997,9.3,10,6,6,3,1,6,11,54.5,5,13,1,12,5,15,5,1,Matches
518,Harry Winks,eng ENG,MF,Leicester City,29-008,1996,16.2,24,11,12,10,2,13,29,44.8,16,15,6,9,8,32,20,0,Matches
519,Ben Winterburn,eng ENG,MF,Bournemouth,20-159,2004,0.1,0,0,0,0,0,0,1,0.0,1,0,0,0,0,0,0,0,Matches
520,Yoane Wissa,cd COD,FW,Brentford,28-160,1996,18.5,10,4,4,1,5,5,11,45.5,6,18,5,13,6,16,10,2,Matches
521,Chris Wood,nz NZL,FW,Nott'ham Forest,33-065,1991,21.3,3,3,0,1,2,1,6,16.7,5,7,4,3,4,7,14,0,Matches
522,Nathan Wood-Gordon,eng ENG,DF,Southampton,22-255,2002,6.4,9,6,5,3,1,5,7,71.4,2,8,5,3,4,13,26,2,Matches
523,Luke Woolfenden,eng ENG,DF,Ipswich Town,26-112,1998,8.2,5,2,2,3,0,1,4,25.0,3,14,8,6,16,21,40,0,Matches
524,Yehor Yarmoliuk,ua UKR,"MF,FW",Brentford,20-346,2004,6.9,21,15,10,7,4,13,28,46.4,15,19,5,14,7,28,21,0,Matches
525,Ryan Yates,eng ENG,MF,Nott'ham Forest,27-081,1997,16.2,33,18,20,9,4,13,28,46.4,15,23,4,19,19,52,44,1,Matches
526,Leny Yoro,fr FRA,DF,Manchester Utd,19-089,2005,6.1,13,4,9,4,0,5,11,45.5,6,2,2,0,13,26,19,0,Matches
527,Ashley Young,eng ENG,DF,Everton,39-216,1985,16.5,46,26,22,18,6,28,46,60.9,18,9,3,6,21,67,53,1,Matches
528,Illia Zabarnyi,ua UKR,DF,Bournemouth,22-162,2002,24.0,40,26,21,18,1,26,37,70.3,11,28,18,10,24,64,122,2,Matches
529,Oleksandr Zinchenko,ua UKR,"DF,MF",Arsenal,28-057,1996,2.7,2,0,1,1,0,1,4,25.0,3,5,0,5,3,5,5,0,Matches
530,Joshua Zirkzee,nl NED,"FW,MF",Manchester Utd,23-264,2001,9.8,11,5,3,6,2,5,5,100.0,0,9,4,5,4,15,3,0,Matches
531,Martin Ødegaard,no NOR,MF,Arsenal,26-055,1998,14.3,16,9,7,6,3,3,17,17.6,14,4,0,4,2,18,2,0,Matches
1,Max Aarons,eng ENG,DF,Bournemouth,23,2000,13.7,29,19,20,7,2,20,34,58.8,14,9,5,4,8,37,27,0,Matches
2,Joshua Acheampong,eng ENG,DF,Chelsea,17,2006,0.1,0,0,0,0,0,0,0,,0,3,3,0,0,0,0,0,Matches
3,Tyler Adams,us USA,MF,Bournemouth,24,1999,1.3,4,3,1,3,0,2,3,66.7,1,2,0,2,4,8,2,0,Matches
4,Tosin Adarabioyo,eng ENG,DF,Fulham,25,1997,18.0,21,11,16,5,0,12,21,57.1,9,16,11,5,25,46,80,0,Matches
5,Elijah Adebayo,eng ENG,FW,Luton Town,25,1998,15.8,4,1,1,0,3,1,12,8.3,11,13,2,11,6,10,25,0,Matches
6,Simon Adingra,ci CIV,FW,Brighton,21,2002,24.7,45,20,23,11,11,19,42,45.2,23,31,1,30,19,64,22,0,Matches
7,Nayef Aguerd,ma MAR,DF,West Ham,27,1996,20.6,26,14,19,7,0,16,22,72.7,6,33,24,9,17,43,85,2,Matches
8,Brandon Aguilera,cr CRC,FW,Nott'ham Forest,20,2003,0.1,0,0,0,0,0,0,0,,0,0,0,0,0,0,0,0,Matches
9,Naouirou Ahamada,fr FRA,"MF,FW",Crystal Palace,21,2002,3.9,13,9,5,6,2,8,17,47.1,9,3,0,3,2,15,4,0,Matches
10,Anel Ahmedhodžić,ba BIH,DF,Sheffield Utd,24,1999,29.4,64,36,48,14,2,30,49,61.2,19,43,26,17,34,98,137,2,Matches
11,Ola Aina,ng NGA,DF,Nott'ham Forest,26,1996,18.8,47,31,31,12,4,29,40,72.5,11,19,3,16,18,65,51,1,Matches
12,Rayan Aït-Nouri,dz ALG,"DF,MF",Wolves,22,2001,25.9,71,44,41,23,7,28,49,57.1,21,32,6,26,15,86,38,0,Matches
13,Kristoffer Ajer,no NOR,DF,Brentford,25,1998,20.4,38,21,25,9,4,23,36,63.9,13,26,11,15,25,63,79,1,Matches
14,Manuel Akanji,ch SUI,"DF,MF",Manchester City,28,1995,27.9,42,28,16,18,8,22,39,56.4,17,28,12,16,23,65,70,3,Matches
15,Nathan Aké,nl NED,DF,Manchester City,28,1995,22.7,26,16,15,8,3,13,20,65.0,7,17,2,15,14,40,54,0,Matches
16,Thiago Alcántara,es ESP,MF,Liverpool,32,1991,0.1,0,0,0,0,0,0,0,,0,0,0,0,0,0,0,0,Matches
17,Trent Alexander-Arnold,eng ENG,DF,Liverpool,24,1998,23.9,39,26,26,11,2,27,87,31.0,60,22,2,20,31,70,48,5,Matches
18,Alisson,br BRA,GK,Liverpool,30,1992,28.0,0,0,0,0,0,0,1,0.0,1,0,0,0,0,0,11,4,Matches
19,Miguel Almirón,py PAR,FW,Newcastle Utd,29,1994,21.5,36,24,13,15,8,11,29,37.9,18,29,2,27,10,46,13,0,Matches
20,Edson Álvarez,mx MEX,MF,West Ham,25,1997,26.4,80,39,47,26,7,31,66,47.0,35,59,20,39,42,122,81,0,Matches
21,Julián Álvarez,ar ARG,"MF,FW",Manchester City,23,2000,29.4,24,13,5,8,11,8,32,25.0,24,30,0,30,2,26,14,1,Matches
22,Zeki Amdouni,ch SUI,FW,Burnley,22,2000,21.7,27,18,1,15,11,7,25,28.0,18,23,10,13,9,36,10,0,Matches
23,Sofyan Amrabat,ma MAR,"MF,DF",Manchester Utd,26,1996,10.4,27,16,17,8,2,17,31,54.8,14,20,7,13,8,35,19,2,Matches
24,Joachim Andersen,dk DEN,DF,Crystal Palace,27,1996,37.9,56,35,33,21,2,29,39,74.4,10,33,18,15,41,97,207,1,Matches
25,Elliot Anderson,eng ENG,"MF,FW",Newcastle Utd,20,2002,11.4,24,18,12,9,3,15,29,51.7,14,23,4,19,8,32,23,0,Matches
26,Jaidon Anthony,eng ENG,FW,Bournemouth,23,1999,1.7,3,1,1,0,2,1,7,14.3,6,3,0,3,1,4,3,0,Matches
27,Michail Antonio,jm JAM,FW,West Ham,33,1990,18.8,15,8,5,6,4,3,11,27.3,8,16,3,13,4,19,4,0,Matches
28,Antony,br BRA,FW,Manchester Utd,23,2000,14.7,40,21,15,19,6,20,40,50.0,20,29,1,28,12,52,9,0,Matches
29,Oliver Arblaster,eng ENG,MF,Sheffield Utd,19,2004,10.5,23,14,11,8,4,7,15,46.7,8,17,7,10,16,39,9,0,Matches
30,Cameron Archer,eng ENG,"FW,MF",Sheffield Utd,22,2001,20.4,18,13,6,6,6,8,18,44.4,10,22,3,19,1,19,11,0,Matches
31,Cameron Archer,eng ENG,MF,Aston Villa,22,2001,0.1,0,0,0,0,0,0,0,,0,0,0,0,0,0,0,0,Matches
32,Alphonse Areola,fr FRA,GK,West Ham,30,1993,30.0,1,1,1,0,0,1,3,33.3,2,0,0,0,1,2,16,0,Matches
33,Lorenz Assignon,tg TOG,DF,Burnley,23,2000,13.7,35,17,18,13,4,14,27,51.9,13,22,7,15,19,54,43,1,Matches
34,Serge Aurier,ci CIV,"DF,MF",Nott'ham Forest,30,1992,9.3,20,14,9,11,0,5,11,45.5,6,10,3,7,9,29,36,1,Matches
35,Taiwo Awoniyi,ng NGA,FW,Nott'ham Forest,25,1997,11.6,9,7,1,4,4,1,2,50.0,1,7,2,5,1,10,9,0,Matches
36,Jordan Ayew,gh GHA,"FW,MF",Crystal Palace,31,1991,28.3,65,36,23,28,14,21,42,50.0,21,43,2,41,16,81,15,0,Matches
37,Benoît Badiashile,fr FRA,DF,Chelsea,22,2001,14.9,21,15,12,9,0,9,14,64.3,5,21,14,7,18,39,66,2,Matches
38,Leon Bailey,jm JAM,"MF,FW",Aston Villa,25,1997,23.0,13,7,7,4,2,5,20,25.0,15,18,1,17,9,22,6,0,Matches
39,Stefan Bajcetic,es ESP,MF,Liverpool,18,2004,0.3,4,1,3,1,0,3,5,60.0,2,0,0,0,0,4,0,0,Matches
40,George Baldock,gr GRE,DF,Sheffield Utd,30,1993,10.8,18,10,10,7,1,6,15,40.0,9,14,8,6,10,28,33,0,Matches
41,Carlos Baleba,cm CMR,MF,Brighton,19,2004,14.7,40,20,17,19,4,23,46,50.0,23,35,7,28,18,58,30,3,Matches
42,Fodé Ballo-Touré,sn SEN,"DF,MF",Fulham,26,1997,0.8,4,2,1,3,0,1,2,50.0,1,1,0,1,3,7,2,0,Matches
43,Shandon Baptiste,gd GRN,MF,Brentford,25,1998,2.5,4,4,2,2,0,1,5,20.0,4,5,1,4,3,7,6,0,Matches
44,Valentín Barco,ar ARG,"DF,FW",Brighton,19,2004,3.4,11,5,4,5,2,6,8,75.0,2,3,0,3,4,15,3,1,Matches
45,Ross Barkley,eng ENG,MF,Luton Town,29,1993,29.1,47,19,16,21,10,11,48,22.9,37,25,9,16,25,72,51,2,Matches
46,Harvey Barnes,eng ENG,"FW,MF",Newcastle Utd,25,1997,8.9,6,1,3,2,1,1,2,50.0,1,1,0,1,5,11,3,0,Matches
47,Chris Basham,eng ENG,"DF,MF",Sheffield Utd,35,1988,3.6,7,2,4,3,0,2,9,22.2,7,9,4,5,5,12,17,0,Matches
48,Calvin Bassey,ng NGA,DF,Fulham,23,1999,25.6,49,29,33,15,1,21,29,72.4,8,32,11,21,28,77,84,4,Matches
49,Owen Beck,wls WAL,DF,Liverpool,20,2002,0.1,2,1,1,1,0,0,0,,0,0,0,0,0,2,1,0,Matches
50,Donny van de Beek,nl NED,DF,Manchester Utd,26,1997,0.0,0,0,0,0,0,0,0,,0,1,0,1,0,0,0,0,Matches
51,Amari'i Bell,jm JAM,DF,Luton Town,29,1994,19.1,50,33,30,19,1,22,35,62.9,13,33,15,18,25,75,60,1,Matches
52,Jean-Ricner Bellegarde,fr FRA,"MF,FW",Wolves,25,1998,10.6,17,10,9,6,2,7,15,46.7,8,18,2,16,8,25,14,0,Matches
53,Anis Ben Slimane,tn TUN,MF,Sheffield Utd,22,2001,4.7,11,6,5,2,4,4,10,40.0,6,7,1,6,5,16,7,0,Matches
54,Saïd Benrahma,dz ALG,"FW,MF",West Ham,27,1995,6.9,8,4,5,3,0,4,15,26.7,11,8,0,8,5,13,7,0,Matches
55,Rodrigo Bentancur,uy URU,MF,Tottenham,26,1997,11.2,23,15,10,11,2,10,24,41.7,14,15,4,11,17,40,16,1,Matches
56,Daniel Bentley,eng ENG,GK,Wolves,30,1993,4.3,0,0,0,0,0,0,1,0.0,1,0,0,0,0,0,1,0,Matches
57,Jóhann Berg Guðmundsson,is ISL,"MF,FW",Burnley,32,1990,13.2,13,4,6,5,2,7,16,43.8,9,14,0,14,16,29,16,0,Matches
58,Sander Berge,no NOR,MF,Burnley,25,1998,33.4,76,46,35,36,5,34,58,58.6,24,49,20,29,23,99,60,2,Matches
59,Luke Berry,eng ENG,"MF,DF",Luton Town,31,1992,3.6,7,2,2,4,1,2,3,66.7,1,6,1,5,0,7,3,0,Matches
60,Beto,gw GNB,FW,Everton,25,1998,10.6,14,6,1,6,7,4,12,33.3,8,11,0,11,1,15,14,0,Matches
61,Jordan Beyer,de GER,DF,Burnley,23,2000,13.7,35,20,22,12,1,14,24,58.3,10,22,15,7,16,51,68,1,Matches
62,Philip Billing,dk DEN,MF,Bournemouth,27,1996,15.5,33,16,7,22,4,9,27,33.3,18,31,5,26,20,53,28,1,Matches
63,Yves Bissouma,ml MLI,MF,Tottenham,26,1996,23.0,80,52,32,36,12,41,61,67.2,20,28,5,23,37,117,43,3,Matches
64,Benicio Boaitey,eng ENG,"FW,DF",Brighton,19,2004,0.4,0,0,0,0,0,0,1,0.0,1,1,0,1,0,0,2,0,Matches
65,Oscar Bobb,no NOR,"FW,MF",Manchester City,20,2003,3.4,7,3,1,2,4,2,4,50.0,2,4,0,4,5,12,1,0,Matches
66,Jayden Bogle,eng ENG,DF,Sheffield Utd,23,2000,31.0,66,36,43,21,2,35,70,50.0,35,42,11,31,32,98,97,0,Matches
67,Willy Boly,ci CIV,DF,Nott'ham Forest,32,1991,16.0,46,29,36,9,1,22,40,55.0,18,32,21,11,25,71,90,0,Matches
68,Sven Botman,nl NED,DF,Newcastle Utd,23,2000,15.3,20,13,14,6,0,8,13,61.5,5,20,16,4,9,29,61,3,Matches
69,Jarrod Bowen,eng ENG,FW,West Ham,26,1996,33.5,42,28,14,14,14,13,35,37.1,22,37,5,32,19,61,14,0,Matches
70,Conor Bradley,nir NIR,DF,Liverpool,20,2003,8.4,33,25,14,12,7,24,38,63.2,14,17,1,16,10,43,14,0,Matches
71,Jarrad Branthwaite,eng ENG,DF,Everton,21,2002,34.6,66,32,42,22,2,45,62,72.6,17,51,36,15,50,116,163,2,Matches
72,Ben Brereton,cl CHI,"FW,MF",Sheffield Utd,24,1999,12.3,9,4,4,4,1,4,10,40.0,6,9,3,6,3,12,12,0,Matches
73,Rhian Brewster,eng ENG,"FW,MF",Sheffield Utd,23,2000,3.8,5,1,1,2,2,0,2,0.0,2,2,0,2,1,6,2,0,Matches
74,Armando Broja,al ALB,FW,Chelsea,21,2001,5.0,3,0,0,1,2,1,2,50.0,1,5,1,4,0,3,3,0,Matches
75,Armando Broja,al ALB,FW,Fulham,21,2001,1.0,0,0,0,0,0,0,0,,0,1,0,1,0,0,0,0,Matches
76,Andre Brooks,eng ENG,"MF,DF",Sheffield Utd,19,2003,10.4,22,13,7,11,4,9,21,42.9,12,13,1,12,14,36,20,0,Matches
77,David Brooks,wls WAL,"FW,MF",Bournemouth,26,1997,3.1,5,4,2,1,2,2,4,50.0,2,3,0,3,2,7,2,0,Matches
78,Jacob Brown,sct SCO,"MF,FW",Luton Town,25,1998,11.3,19,12,7,7,5,7,18,38.9,11,20,1,19,8,27,22,0,Matches
79,Josh Brownhill,eng ENG,MF,Burnley,27,1995,25.0,61,35,23,28,10,27,37,73.0,10,33,8,25,34,95,40,1,Matches
80,Jacob Bruun Larsen,dk DEN,"MF,FW",Burnley,24,1998,13.9,9,4,4,3,2,7,21,33.3,14,16,2,14,7,16,23,0,Matches
81,Hugo Bueno,es ESP,"DF,MF",Wolves,20,2002,8.2,21,14,12,7,2,12,19,63.2,7,17,4,13,6,27,24,0,Matches
82,Santiago Bueno,uy URU,DF,Wolves,24,1998,9.1,13,7,5,7,1,5,11,45.5,6,22,12,10,6,19,33,0,Matches
83,Facundo Buonanotte,ar ARG,"FW,MF",Brighton,18,2004,15.2,42,22,13,22,7,14,44,31.8,30,22,3,19,8,50,5,0,Matches
84,Reece Burke,eng ENG,DF,Luton Town,26,1996,18.4,37,23,17,14,6,12,26,46.2,14,25,18,7,18,55,78,1,Matches
85,Dan Burn,eng ENG,DF,Newcastle Utd,31,1992,30.3,61,33,37,20,4,26,61,42.6,35,55,25,30,37,98,124,1,Matches
86,Mason Burstow,eng ENG,FW,Chelsea,19,2003,0.1,0,0,0,0,0,0,0,,0,0,0,0,0,0,0,0,Matches
87,Moisés Caicedo,ec ECU,MF,Chelsea,21,2001,31.8,91,46,38,42,11,36,60,60.0,24,59,25,34,37,128,44,4,Matches
88,Tom Cairney,sct SCO,MF,Fulham,32,1991,16.5,24,16,10,12,2,13,25,52.0,12,16,4,12,13,37,6,0,Matches
89,Dominic Calvert-Lewin,eng ENG,FW,Everton,26,1997,24.1,13,6,2,6,5,2,15,13.3,13,14,4,10,4,17,38,0,Matches
90,Thomas Cannon,ie IRL,FW,Everton,20,2002,0.0,0,0,0,0,0,0,0,,0,0,0,0,0,0,0,0,Matches
91,Diego Carlos,br BRA,DF,Aston Villa,30,1993,20.2,27,16,22,4,1,13,21,61.9,8,24,19,5,13,40,78,3,Matches
92,Cesare Casadei,it ITA,"FW,MF",Chelsea,20,2003,0.9,5,3,2,1,2,2,5,40.0,3,1,0,1,0,5,4,0,Matches
93,Casemiro,br BRA,"MF,DF",Manchester Utd,31,1992,22.0,83,56,43,32,8,51,106,48.1,55,74,33,41,18,101,71,1,Matches
94,Kaelan Casey,eng ENG,DF,West Ham,18,2004,0.0,0,0,0,0,0,0,0,,0,0,0,0,0,0,1,0,Matches
95,Matty Cash,pl POL,DF,Aston Villa,25,1997,23.8,54,31,24,24,6,29,59,49.2,30,35,14,21,18,72,59,0,Matches
96,Timothy Castagne,be BEL,DF,Fulham,27,1995,29.3,49,24,23,16,10,26,44,59.1,18,38,10,28,38,87,69,1,Matches
97,Jonny Castro,es ESP,MF,Wolves,29,1994,0.1,0,0,0,0,0,0,1,0.0,1,1,1,0,0,0,0,0,Matches
98,Trevoh Chalobah,eng ENG,DF,Chelsea,24,1999,10.6,16,12,10,2,4,10,15,66.7,5,8,7,1,8,24,51,0,Matches
99,Calum Chambers,eng ENG,"MF,DF",Aston Villa,28,1995,1.7,3,0,3,0,0,0,1,0.0,1,2,1,1,2,5,4,0,Matches
100,Youssef Chermiti,pt POR,FW,Everton,19,2004,2.3,3,2,2,1,0,1,5,20.0,4,4,1,3,1,4,2,0,Matches
101,Ben Chilwell,eng ENG,DF,Chelsea,26,1996,8.4,15,10,5,9,1,5,8,62.5,3,11,3,8,4,19,19,1,Matches
102,Tawanda Chirewa,zw ZIM,"MF,FW",Wolves,19,2003,1.6,7,3,3,3,1,2,3,66.7,1,0,0,0,1,8,0,0,Matches
103,Leon Chiwome,eng ENG,FW,Wolves,17,2006,1.9,2,1,0,1,1,1,2,50.0,1,3,1,2,0,2,2,0,Matches
104,Tahith Chong,nl NED,"MF,FW",Luton Town,23,1999,22.0,36,22,19,13,4,15,33,45.5,18,30,6,24,8,44,11,1,Matches
105,Ryan Christie,sct SCO,MF,Bournemouth,28,1995,32.3,86,44,34,35,17,39,92,42.4,53,52,11,41,52,138,53,1,Matches
106,Carney Chukwuemeka,eng ENG,"MF,FW",Chelsea,19,2003,2.5,6,4,3,3,0,1,3,33.3,2,1,1,0,0,6,1,0,Matches
107,Bobby Clark,eng ENG,MF,Liverpool,18,2005,1.0,2,1,1,1,0,1,5,20.0,4,6,2,4,1,3,1,0,Matches
108,Jordan Clark,eng ENG,MF,Luton Town,29,1993,14.5,30,17,14,11,5,11,39,28.2,28,24,3,21,11,41,15,1,Matches
109,Nathaniel Clyne,eng ENG,DF,Crystal Palace,32,1991,14.9,24,15,11,11,2,14,21,66.7,7,18,6,12,10,34,33,0,Matches
110,Séamus Coleman,ie IRL,DF,Everton,34,1988,7.4,17,14,10,3,4,11,16,68.8,5,12,4,8,7,24,26,1,Matches
111,Nathan Collins,ie IRL,DF,Brentford,22,2001,29.5,38,20,24,12,2,19,29,65.5,10,46,30,16,44,82,141,4,Matches
112,Levi Colwill,eng ENG,DF,Chelsea,20,2003,20.0,48,30,26,17,5,26,34,76.5,8,28,10,18,26,74,66,0,Matches
113,Lewis Cook,eng ENG,MF,Bournemouth,26,1997,31.0,61,41,24,30,7,34,63,54.0,29,32,11,21,65,126,46,1,Matches
114,Jack Cork,eng ENG,MF,Burnley,34,1989,0.3,2,0,0,2,0,1,3,33.3,2,0,0,0,1,3,1,0,Matches
115,Maxwel Cornet,ci CIV,"MF,FW",West Ham,26,1996,1.2,3,2,3,0,0,1,5,20.0,4,2,0,2,2,5,1,0,Matches
116,Vladimír Coufal,cz CZE,DF,West Ham,30,1992,34.8,64,41,50,12,2,38,75,50.7,37,49,15,34,43,107,97,0,Matches
117,Philippe Coutinho,br BRA,"MF,FW",Aston Villa,31,1992,0.3,0,0,0,0,0,0,1,0.0,1,0,0,0,0,0,0,0,Matches
118,Aaron Cresswell,eng ENG,"DF,FW",West Ham,33,1989,4.8,3,2,1,1,1,2,3,66.7,1,5,3,2,3,6,7,0,Matches
119,Marc Cucurella,es ESP,DF,Chelsea,25,1998,19.8,62,38,36,21,5,34,64,53.1,30,36,13,23,22,84,48,0,Matches
120,Josh Cullen,ie IRL,MF,Burnley,27,1996,22.9,42,29,15,22,5,26,46,56.5,20,31,19,12,15,57,26,1,Matches
121,Matheus Cunha,br BRA,"FW,MF",Wolves,24,1999,27.1,30,16,8,17,5,13,35,37.1,22,28,7,21,13,43,21,1,Matches
122,Sam Curtis,ie IRL,DF,Sheffield Utd,17,2005,0.3,1,0,1,0,0,1,2,50.0,1,2,0,2,0,1,0,0,Matches
123,Mahmoud Dahoud,de GER,MF,Brighton,27,1996,5.0,9,4,2,4,3,3,9,33.3,6,4,1,3,1,10,5,0,Matches
124,Ameen Al-Dakhil,be BEL,DF,Burnley,21,2002,11.7,12,5,4,7,1,1,10,10.0,9,13,6,7,12,24,38,2,Matches
125,Diogo Dalot,pt POR,DF,Manchester Utd,24,1999,35.3,81,51,58,12,11,51,74,68.9,23,44,16,28,37,118,111,0,Matches
126,Mikkel Damsgaard,dk DEN,MF,Brentford,23,2000,9.4,29,17,13,9,7,14,40,35.0,26,23,1,22,11,40,10,1,Matches
127,Danilo,br BRA,MF,Nott'ham Forest,22,2001,19.9,36,18,22,12,2,21,46,45.7,25,34,8,26,35,71,42,0,Matches
128,Arnaut Danjuma,nl NED,"MF,FW",Everton,26,1997,6.6,6,4,2,3,1,1,4,25.0,3,4,0,4,3,9,0,0,Matches
129,Jayden Danns,eng ENG,FW,Liverpool,17,2006,0.1,0,0,0,0,0,0,0,,0,0,0,0,0,0,0,0,Matches
130,Josh Dasilva,eng ENG,"DF,FW",Brentford,24,1998,0.3,2,1,0,1,1,0,0,,0,0,0,0,0,2,0,0,Matches
131,David Datro Fofana,ci CIV,FW,Burnley,20,2002,9.8,10,5,3,5,2,3,6,50.0,3,9,3,6,1,11,2,0,Matches
132,Ben Davies,wls WAL,DF,Tottenham,30,1993,12.1,24,17,13,8,3,16,21,76.2,5,17,15,2,10,34,35,0,Matches
133,Tom Davies,eng ENG,MF,Sheffield Utd,25,1998,2.5,10,5,4,3,3,3,9,33.3,6,2,1,1,3,13,6,1,Matches
134,Craig Dawson,eng ENG,DF,Wolves,33,1990,24.5,30,20,23,6,1,22,34,64.7,12,51,39,12,16,46,120,1,Matches
135,Kevin De Bruyne,be BEL,MF,Manchester City,32,1991,13.6,14,9,1,5,8,7,20,35.0,13,5,0,5,4,18,4,0,Matches
136,Hannes Delcroix,be BEL,DF,Burnley,24,1999,6.5,10,6,6,4,0,3,4,75.0,1,9,3,6,9,19,26,0,Matches
137,Leander Dendoncker,be BEL,MF,Aston Villa,28,1995,1.3,6,4,3,2,1,4,5,80.0,1,5,2,3,2,8,3,1,Matches
138,Moussa Diaby,fr FRA,"FW,MF",Aston Villa,24,1999,24.2,12,5,5,4,3,4,22,18.2,18,8,1,7,9,21,6,0,Matches
139,Amad Diallo,ci CIV,"FW,MF",Manchester Utd,21,2002,4.3,10,3,1,6,3,3,7,42.9,4,3,1,2,1,11,6,0,Matches
140,Amadou Diallo,eng ENG,MF,Newcastle Utd,20,2003,0.0,0,0,0,0,0,0,0,,0,0,0,0,0,0,0,0,Matches
141,Rúben Dias,pt POR,DF,Manchester City,26,1997,28.4,39,20,14,21,4,19,26,73.1,7,32,17,15,30,69,77,0,Matches
142,Luis Díaz,co COL,FW,Liverpool,26,1997,29.2,35,25,5,17,13,7,30,23.3,23,15,0,15,3,38,8,0,Matches
143,Eric Dier,eng ENG,DF,Tottenham,29,1994,2.2,2,1,2,0,0,2,2,100.0,0,3,3,0,2,4,12,0,Matches
144,Lucas Digne,fr FRA,DF,Aston Villa,30,1993,26.8,47,19,35,9,3,25,44,56.8,19,20,2,18,26,73,67,0,Matches
145,Issa Diop,fr FRA,DF,Fulham,26,1997,15.8,30,16,23,5,2,15,20,75.0,5,28,19,9,17,47,80,1,Matches
146,Axel Disasi,fr FRA,DF,Chelsea,25,1998,28.7,33,19,20,10,3,23,30,76.7,7,26,19,7,18,51,102,2,Matches
147,Ben Doak,sct SCO,FW,Liverpool,17,2005,0.2,0,0,0,0,0,0,0,,0,0,0,0,0,0,0,0,Matches
148,Lewis Dobbin,eng ENG,MF,Everton,20,2003,2.6,9,7,3,5,1,5,9,55.6,4,5,1,4,1,10,0,0,Matches
149,Matt Doherty,ie IRL,"DF,MF",Wolves,31,1992,12.8,31,18,17,10,4,12,23,52.2,11,15,5,10,7,38,47,0,Matches
150,Jeremy Doku,be BEL,"FW,MF",Manchester City,21,2002,17.7,39,22,13,12,14,9,20,45.0,11,14,0,14,9,48,5,0,Matches
151,Nicolás Domínguez,ar ARG,"MF,FW",Nott'ham Forest,25,1998,16.6,63,34,35,27,1,23,48,47.9,25,31,5,26,18,81,24,0,Matches
152,Jamie Donley,eng ENG,FW,Tottenham,18,2005,0.0,0,0,0,0,0,0,0,,0,0,0,0,0,0,3,0,Matches
153,Abdoulaye Doucouré,ml MLI,"FW,MF",Everton,30,1993,29.2,43,27,20,14,9,18,46,39.1,28,23,3,20,15,58,19,0,Matches
154,Cheick Doucouré,ml MLI,MF,Crystal Palace,23,2000,10.2,34,17,15,13,6,18,30,60.0,12,13,2,11,20,54,12,0,Matches
155,Alfie Doughty,eng ENG,DF,Luton Town,23,1999,32.5,63,40,29,18,16,37,82,45.1,45,51,9,42,31,94,43,4,Matches
156,Tommy Doyle,eng ENG,MF,Wolves,21,2001,13.6,26,13,11,10,5,14,23,60.9,9,22,9,13,12,38,18,0,Matches
157,Radu Drăgușin,ro ROU,DF,Tottenham,21,2002,4.8,5,3,5,0,0,3,3,100.0,0,5,4,1,8,13,19,0,Matches
158,Martin Dúbravka,sk SVK,GK,Newcastle Utd,34,1989,22.1,0,0,0,0,0,0,4,0.0,4,0,0,0,0,0,8,1,Matches
159,Paul Dummett,wls WAL,DF,Newcastle Utd,31,1991,0.2,1,0,1,0,0,1,1,100.0,0,0,0,0,0,1,1,0,Matches
160,Lewis Dunk,eng ENG,DF,Brighton,31,1991,31.9,27,14,17,9,1,13,36,36.1,23,49,37,12,31,58,90,1,Matches
161,Jáder Durán,co COL,"FW,MF",Aston Villa,19,2003,5.3,6,5,3,1,2,1,6,16.7,5,6,0,6,1,7,10,0,Matches
162,George Earthy,eng ENG,FW,West Ham,18,2004,0.4,0,0,0,0,0,0,1,0.0,1,0,0,0,1,1,0,0,Matches
163,Ederson,br BRA,GK,Manchester City,29,1993,30.9,0,0,0,0,0,0,1,0.0,1,0,0,0,0,0,10,1,Matches
164,Odsonne Édouard,fr FRA,"FW,MF",Crystal Palace,25,1998,17.3,24,12,8,8,8,4,19,21.1,15,17,1,16,6,30,19,0,Matches
165,John Egan,ie IRL,DF,Sheffield Utd,30,1992,5.4,6,4,4,2,0,4,11,36.4,7,10,4,6,13,19,39,1,Matches
166,Hjalmar Ekdal,se SWE,DF,Burnley,24,1998,4.9,4,2,2,2,0,2,4,50.0,2,10,5,5,6,10,21,0,Matches
167,Anthony Elanga,se SWE,"FW,MF",Nott'ham Forest,21,2002,27.0,33,19,20,6,7,17,37,45.9,20,22,2,20,8,41,20,1,Matches
168,Harvey Elliott,eng ENG,"MF,FW",Liverpool,20,2003,15.0,27,17,8,14,5,10,31,32.3,21,27,0,27,6,33,7,0,Matches
169,Mohamed Elneny,eg EGY,MF,Arsenal,31,1992,0.3,0,0,0,0,0,0,1,0.0,1,0,0,0,1,1,0,0,Matches
170,Emerson,br BRA,DF,Tottenham,24,1999,12.9,36,24,23,10,3,21,43,48.8,22,23,10,13,20,56,50,1,Matches
171,Julio Enciso,py PAR,"MF,FW",Brighton,19,2004,5.3,6,2,3,2,1,2,7,28.6,5,11,0,11,0,6,3,0,Matches
172,Wataru Endo,jp JPN,MF,Liverpool,30,1993,19.1,48,28,11,31,6,20,61,32.8,41,24,2,22,20,68,31,3,Matches
173,Christian Eriksen,dk DEN,MF,Manchester Utd,31,1992,12.7,18,13,5,10,3,12,33,36.4,21,17,6,11,4,22,13,0,Matches
174,Maxime Estève,fr FRA,DF,Burnley,21,2002,14.5,27,10,15,12,0,18,32,56.3,14,21,10,11,27,54,56,0,Matches
175,Pervis Estupiñán,ec ECU,DF,Brighton,25,1998,13.8,26,13,12,11,3,14,30,46.7,16,14,4,10,21,47,20,0,Matches
176,Jonny Evans,nir NIR,DF,Manchester Utd,35,1988,15.5,22,14,20,2,0,12,21,57.1,9,25,18,7,23,45,76,0,Matches
177,Eberechi Eze,eng ENG,"MF,FW",Crystal Palace,25,1998,22.8,35,17,4,18,13,15,31,48.4,16,27,2,25,11,46,6,0,Matches
178,Łukasz Fabiański,pl POL,GK,West Ham,38,1985,8.0,1,0,1,0,0,1,2,50.0,1,0,0,0,1,2,4,0,Matches
179,Romain Faivre,fr FRA,"MF,FW",Bournemouth,25,1998,0.5,1,1,0,1,0,0,3,0.0,3,0,0,0,0,1,0,0,Matches
180,Ansu Fati,es ESP,"MF,FW",Brighton,20,2002,5.8,5,3,1,2,2,1,11,9.1,10,8,0,8,3,8,3,0,Matches
181,Felipe,br BRA,DF,Nott'ham Forest,34,1989,4.2,12,9,9,3,0,9,12,75.0,3,4,1,3,4,16,12,0,Matches
182,Evan Ferguson,ie IRL,FW,Brighton,18,2004,15.2,14,6,4,7,3,5,14,35.7,9,10,3,7,2,16,8,0,Matches
183,Bruno Fernandes,pt POR,"MF,FW",Manchester Utd,28,1994,34.6,68,38,27,25,16,30,88,34.1,58,49,6,43,27,95,50,2,Matches
184,Enzo Fernández,ar ARG,MF,Chelsea,22,2001,24.5,50,22,22,18,10,27,65,41.5,38,36,13,23,17,67,28,0,Matches
185,John Fleck,sct SCO,"MF,DF",Sheffield Utd,31,1991,1.0,1,0,0,1,0,0,1,0.0,1,0,0,0,0,1,1,0,Matches
186,Mark Flekken,nl NED,GK,Brentford,30,1993,36.5,1,1,1,0,0,1,5,20.0,4,1,0,1,0,1,17,1,Matches
187,Phil Foden,eng ENG,"FW,MF",Manchester City,23,2000,31.7,31,20,11,10,10,13,31,41.9,18,30,0,30,13,44,18,1,Matches
188,Wes Foderingham,eng ENG,GK,Sheffield Utd,32,1991,29.4,5,3,5,0,0,5,6,83.3,1,0,0,0,0,5,18,6,Matches
189,Pablo Fornals,es ESP,"MF,FW",West Ham,27,1996,4.7,10,6,4,3,3,5,16,31.3,11,8,1,7,6,16,7,0,Matches
190,Omari Forson,eng ENG,FW,Manchester Utd,19,2004,0.8,2,0,0,2,0,1,1,100.0,0,0,0,0,0,2,0,0,Matches
191,Lyle Foster,za RSA,"FW,MF",Burnley,22,2000,21.1,19,10,5,6,8,6,17,35.3,11,13,3,10,3,22,34,0,Matches
192,Matheus França,br BRA,"MF,FW",Crystal Palace,19,2004,2.6,3,3,2,1,0,1,7,14.3,6,4,0,4,1,4,1,0,Matches
193,Nathan Fraser,ie IRL,FW,Wolves,18,2005,2.1,5,2,2,1,2,1,3,33.3,2,2,1,1,1,6,2,0,Matches
194,Cody Gakpo,nl NED,"FW,MF",Liverpool,24,1999,18.3,27,17,8,14,5,8,25,32.0,17,21,4,17,14,41,7,0,Matches
195,Conor Gallagher,eng ENG,MF,Chelsea,23,2000,34.8,85,52,37,31,17,33,77,42.9,44,50,11,39,43,128,34,0,Matches
196,Idrissa Gana Gueye,sn SEN,MF,Everton,33,1989,20.9,73,44,32,27,14,29,46,63.0,17,24,7,17,28,101,16,0,Matches
197,Alejandro Garnacho,ar ARG,FW,Manchester Utd,19,2004,28.5,22,15,7,6,9,12,45,26.7,33,26,2,24,18,40,18,0,Matches
198,James Garner,eng ENG,MF,Everton,22,2001,33.4,83,44,32,38,13,35,82,42.7,47,45,14,31,45,128,47,1,Matches
199,Saman Ghoddos,ir IRN,DF,Brentford,29,1993,8.2,28,19,19,7,2,17,31,54.8,14,9,2,7,5,33,12,0,Matches
200,Morgan Gibbs-White,eng ENG,"MF,FW",Nott'ham Forest,23,2000,35.1,36,24,6,20,10,14,33,42.4,19,31,8,23,17,53,21,0,Matches
201,Bryan Gil,es ESP,"FW,MF",Tottenham,22,2001,2.3,1,0,0,0,1,1,4,25.0,3,3,0,3,3,4,4,0,Matches
202,Alfie Gilchrist,eng ENG,DF,Chelsea,19,2003,2.3,4,0,4,0,0,2,5,40.0,3,6,3,3,3,7,11,0,Matches
203,Ryan Giles,eng ENG,"DF,MF",Luton Town,23,2000,5.6,8,6,4,3,1,2,7,28.6,5,2,0,2,4,12,22,0,Matches
204,Billy Gilmour,sct SCO,MF,Brighton,22,2001,23.6,26,16,14,10,2,11,35,31.4,24,23,9,14,11,37,14,1,Matches
205,Ben Godfrey,eng ENG,DF,Everton,25,1998,12.4,30,20,17,8,5,15,28,53.6,13,14,8,6,16,46,57,0,Matches
206,André Gomes,pt POR,"MF,FW",Everton,30,1993,5.6,7,4,2,3,2,3,13,23.1,10,10,1,9,3,10,4,1,Matches
207,João Gomes,br BRA,MF,Wolves,22,2001,29.4,128,74,67,49,12,44,99,44.4,55,51,8,43,18,146,29,2,Matches
208,Toti Gomes,pt POR,DF,Wolves,24,1999,30.8,44,25,32,8,4,24,37,64.9,13,40,19,21,26,70,93,2,Matches
209,Joe Gomez,eng ENG,DF,Liverpool,26,1997,19.8,47,31,24,16,7,30,63,47.6,33,26,4,22,19,66,50,2,Matches
210,Sergio Gómez,es ESP,"FW,MF",Manchester City,22,2000,0.6,1,0,0,1,0,1,2,50.0,1,0,0,0,1,2,0,0,Matches
211,Enso Gonzalez,py PAR,"MF,DF",Wolves,18,2005,0.0,0,0,0,0,0,0,1,0.0,1,0,0,0,0,0,0,0,Matches
212,Anthony Gordon,eng ENG,FW,Newcastle Utd,22,2001,32.1,55,34,16,28,11,22,64,34.4,42,27,0,27,7,62,7,0,Matches
213,Kaide Gordon,eng ENG,FW,Liverpool,18,2004,0.0,0,0,0,0,0,0,0,,0,0,0,0,0,0,0,0,Matches
214,Daniel Gore,eng ENG,MF,Manchester Utd,18,2004,0.0,1,1,0,1,0,1,1,100.0,0,0,0,0,1,2,0,0,Matches
215,Ryan Gravenberch,nl NED,MF,Liverpool,21,2002,12.5,26,12,5,13,8,12,29,41.4,17,20,2,18,14,40,11,0,Matches
216,Ivo Grbić,hr CRO,GK,Sheffield Utd,27,1996,8.6,0,0,0,0,0,0,1,0.0,1,1,0,1,0,0,9,1,Matches
217,Jack Grealish,eng ENG,"FW,MF",Manchester City,27,1995,11.2,13,8,6,7,0,6,12,50.0,6,13,2,11,6,19,5,0,Matches
218,Pascal Groß,de GER,"MF,DF",Brighton,32,1991,34.6,70,46,33,21,16,31,72,43.1,41,41,8,33,22,92,32,3,Matches
219,Marc Guéhi,eng ENG,DF,Crystal Palace,23,2000,22.5,28,19,21,7,0,14,24,58.3,10,22,17,5,18,46,89,1,Matches
220,Bruno Guimarães,br BRA,MF,Newcastle Utd,25,1997,36.3,88,53,45,32,11,40,77,51.9,37,52,14,38,35,123,20,0,Matches
221,Malo Gusto,fr FRA,DF,Chelsea,20,2003,19.5,55,27,34,15,6,35,52,67.3,17,28,4,24,17,72,43,1,Matches
222,Joško Gvardiol,hr CRO,DF,Manchester City,21,2002,25.9,55,33,21,24,10,21,38,55.3,17,36,12,24,27,82,37,3,Matches
223,Erling Haaland,no NOR,FW,Manchester City,23,2000,28.4,6,3,0,3,3,2,3,66.7,1,11,1,10,2,8,16,0,Matches
224,Antwoine Hackford,eng ENG,FW,Sheffield Utd,19,2004,0.1,0,0,0,0,0,0,0,,0,0,0,0,0,0,0,0,Matches
225,Lewis Hall,eng ENG,DF,Newcastle Utd,18,2004,8.7,28,18,17,10,1,17,28,60.7,11,17,2,15,12,40,22,1,Matches
226,Gustavo Hamer,nl NED,MF,Sheffield Utd,26,1997,32.3,39,21,17,15,7,16,59,27.1,43,33,9,24,29,68,35,0,Matches
227,Luke Harris,wls WAL,MF,Fulham,18,2005,0.8,1,1,1,0,0,0,1,0.0,1,0,0,0,0,1,0,0,Matches
228,Jack Harrison,eng ENG,"MF,FW",Everton,26,1996,24.6,37,22,12,12,13,17,49,34.7,32,25,5,20,12,49,24,0,Matches
229,Daiki Hashioka,jp JPN,DF,Luton Town,24,1999,6.6,11,5,6,4,1,5,11,45.5,6,12,7,5,8,19,20,0,Matches
230,Kai Havertz,de GER,"MF,FW",Arsenal,24,1999,29.3,35,15,7,21,7,14,39,35.9,25,26,1,25,20,55,22,0,Matches
231,Jan Paul van Hecke,nl NED,DF,Brighton,23,2000,26.3,47,26,25,19,3,27,45,60.0,18,49,27,22,30,77,76,4,Matches
232,Hwang Hee-chan,kr KOR,"FW,MF",Wolves,27,1996,23.5,20,10,11,8,1,9,24,37.5,15,19,1,18,10,30,9,0,Matches
233,Dean Henderson,eng ENG,GK,Crystal Palace,26,1997,18.0,1,1,1,0,0,1,2,50.0,1,0,0,0,0,1,8,2,Matches
234,Rico Henry,eng ENG,DF,Brentford,26,1997,4.5,7,5,3,3,1,6,7,85.7,1,8,3,5,5,12,5,1,Matches
235,Son Heung-min,kr KOR,FW,Tottenham,31,1992,32.6,21,13,6,7,8,10,21,47.6,11,4,1,3,8,29,4,0,Matches
236,Aaron Hickey,sct SCO,DF,Brentford,21,2002,7.9,16,9,9,3,4,7,7,100.0,0,7,3,4,3,19,10,0,Matches
237,James Hill,eng ENG,DF,Bournemouth,21,2002,0.8,3,2,1,2,0,1,1,100.0,0,3,2,1,3,6,8,0,Matches
238,Jack Hinshelwood,eng ENG,DF,Brighton,18,2005,9.7,14,5,7,4,3,5,13,38.5,8,6,2,4,14,28,18,0,Matches
239,Mason Holgate,eng ENG,DF,Sheffield Utd,26,1996,7.9,12,7,5,6,1,5,12,41.7,7,12,5,7,11,23,40,0,Matches
240,Callum Hudson-Odoi,eng ENG,"FW,MF",Nott'ham Forest,22,2000,20.6,18,8,4,5,9,7,28,25.0,21,16,1,15,7,25,12,1,Matches
241,Will Hughes,eng ENG,MF,Crystal Palace,28,1995,21.0,61,33,30,20,11,24,48,50.0,24,36,14,22,21,82,25,0,Matches
242,Pierre Højbjerg,dk DEN,MF,Tottenham,27,1995,14.6,32,18,13,17,2,13,34,38.2,21,21,7,14,19,51,30,3,Matches
243,Rasmus Højlund,dk DEN,FW,Manchester Utd,20,2003,24.0,11,7,2,3,6,5,13,38.5,8,9,1,8,1,12,19,0,Matches
244,Igor,br BRA,DF,Brighton,25,1998,18.2,25,18,7,16,2,17,29,58.6,12,22,9,13,14,39,52,1,Matches
245,Danny Ings,eng ENG,FW,West Ham,31,1992,4.5,6,2,0,6,0,4,13,30.8,9,4,1,3,3,9,7,0,Matches
246,Tim Iroegbunam,eng ENG,MF,Aston Villa,20,2003,1.8,7,5,4,2,1,4,9,44.4,5,3,0,3,2,9,3,0,Matches
247,Alexander Isak,se SWE,FW,Newcastle Utd,23,1999,25.1,5,0,2,1,2,2,8,25.0,6,16,1,15,6,11,13,0,Matches
248,Alex Iwobi,ng NGA,MF,Everton,27,1996,1.6,2,0,1,0,1,2,3,66.7,1,2,0,2,1,3,0,0,Matches
249,Alex Iwobi,ng NGA,"FW,MF",Fulham,27,1996,24.4,29,18,12,15,2,12,25,48.0,13,16,0,16,14,43,9,0,Matches
250,Nicolas Jackson,sn SEN,FW,Chelsea,22,2001,31.1,21,13,5,8,8,5,24,20.8,19,20,5,15,4,25,17,0,Matches
251,Reece James,eng ENG,DF,Chelsea,23,1999,4.7,14,9,10,3,1,8,10,80.0,2,4,4,0,3,17,7,1,Matches
252,Vitaly Janelt,de GER,"MF,DF",Brentford,25,1998,33.9,63,38,29,25,9,32,64,50.0,32,35,9,26,36,99,64,3,Matches
253,Daniel Jebbison,eng ENG,FW,Sheffield Utd,19,2003,0.2,0,0,0,0,0,0,0,,0,1,0,1,0,0,0,0,Matches
254,Mathias Jensen,dk DEN,MF,Brentford,27,1996,24.5,54,32,25,22,7,26,95,27.4,69,41,6,35,23,77,25,1,Matches
255,Gabriel Jesus,br BRA,FW,Arsenal,26,1997,16.4,24,17,11,5,8,5,18,27.8,13,23,1,22,13,37,12,0,Matches
256,Raúl Jiménez,mx MEX,FW,Fulham,32,1991,15.5,18,12,4,8,6,7,20,35.0,13,11,3,8,4,22,13,0,Matches
257,João Pedro,br BRA,"FW,MF",Brighton,21,2001,22.7,31,14,10,13,8,14,24,58.3,10,15,2,13,11,42,28,0,Matches
258,Joelinton,br BRA,"MF,FW",Newcastle Utd,26,1996,14.2,39,27,21,15,3,14,38,36.8,24,23,7,16,19,58,11,1,Matches
259,Ben Johnson,eng ENG,"DF,FW",West Ham,23,2000,6.0,11,7,7,3,1,9,14,64.3,5,2,1,1,5,16,14,0,Matches
260,Brennan Johnson,wls WAL,FW,Tottenham,22,2001,23.2,26,15,14,5,7,12,31,38.7,19,37,1,36,10,36,12,1,Matches
261,Brennan Johnson,wls WAL,"FW,MF",Nott'ham Forest,22,2001,2.6,4,1,1,1,2,2,4,50.0,2,4,1,3,0,4,0,0,Matches
262,Joseph Johnson,eng ENG,DF,Luton Town,17,2006,0.9,0,0,0,0,0,0,1,0.0,1,0,0,0,0,0,0,0,Matches
263,Sam Johnstone,eng ENG,GK,Crystal Palace,30,1993,20.0,1,0,1,0,0,1,1,100.0,0,0,0,0,1,2,5,0,Matches
264,Curtis Jones,eng ENG,MF,Liverpool,22,2001,13.0,27,14,12,12,3,10,23,43.5,13,22,0,22,7,34,8,0,Matches
265,Jorginho,it ITA,MF,Arsenal,31,1991,10.2,24,10,6,10,8,11,23,47.8,12,17,1,16,12,36,7,1,Matches
266,Diogo Jota,pt POR,FW,Liverpool,26,1996,12.7,23,13,6,13,4,10,23,43.5,13,9,1,8,7,30,4,0,Matches
267,Mads Juel Andersen,dk DEN,DF,Luton Town,25,1997,4.4,6,5,4,2,0,4,4,100.0,0,9,6,3,8,14,29,0,Matches
268,Hamed Junior Traorè,ci CIV,MF,Bournemouth,23,2000,0.5,1,0,1,0,0,1,3,33.3,2,3,0,3,0,1,0,0,Matches
269,Mathias Jørgensen,dk DEN,DF,Brentford,33,1990,12.1,17,12,15,1,1,11,19,57.9,8,9,5,4,12,29,40,0,Matches
270,Issa Kaboré,bf BFA,DF,Luton Town,22,2001,19.2,52,28,23,21,8,24,45,53.3,21,22,11,11,16,68,56,2,Matches
271,Sasa Kalajdzic,at AUT,FW,Wolves,26,1997,1.8,6,2,3,2,1,1,2,50.0,1,3,0,3,1,7,6,0,Matches
272,Boubacar Kamara,fr FRA,MF,Aston Villa,23,1999,18.4,43,29,16,21,6,24,47,51.1,23,21,7,14,21,64,16,0,Matches
273,Willy Kambwala,fr FRA,DF,Manchester Utd,18,2004,3.7,3,1,1,2,0,1,3,33.3,2,6,3,3,4,7,14,1,Matches
274,Thomas Kaminski,be BEL,GK,Luton Town,30,1992,37.8,2,1,2,0,0,2,6,33.3,4,1,0,1,0,2,14,2,Matches
275,Loris Karius,de GER,GK,Newcastle Utd,30,1993,1.0,0,0,0,0,0,0,0,,0,0,0,0,0,0,1,0,Matches
276,Michael Keane,eng ENG,DF,Everton,30,1993,4.9,7,3,3,3,1,1,7,14.3,6,5,4,1,5,12,18,1,Matches
277,Thilo Kehrer,de GER,"DF,MF",West Ham,26,1996,0.2,1,1,0,1,0,0,0,,0,2,2,0,0,1,0,0,Matches
278,Caoimhín Kelleher,ie IRL,GK,Liverpool,24,1998,10.0,0,0,0,0,0,0,0,,0,0,0,0,0,0,4,1,Matches
279,Lloyd Kelly,eng ENG,DF,Bournemouth,24,1998,17.3,24,19,10,9,5,14,25,56.0,11,22,12,10,13,37,67,0,Matches
280,Omari Kellyman,eng ENG,FW,Aston Villa,17,2005,0.4,1,0,0,1,0,1,2,50.0,1,0,0,0,0,1,0,0,Matches
281,Milos Kerkez,hu HUN,DF,Bournemouth,19,2003,21.9,47,26,31,13,3,30,42,71.4,12,31,11,20,20,67,60,2,Matches
282,Kaine Kesler-Hayden,eng ENG,"MF,DF",Aston Villa,20,2002,0.1,0,0,0,0,0,0,0,,0,0,0,0,0,0,0,0,Matches
283,Max Kilman,eng ENG,DF,Wolves,26,1997,38.0,47,21,40,6,1,24,32,75.0,8,64,37,27,39,86,182,4,Matches
284,Jakub Kiwior,pl POL,DF,Arsenal,23,2000,10.5,20,12,11,8,1,14,19,73.7,5,11,3,8,8,28,28,1,Matches
285,Justin Kluivert,nl NED,"MF,FW",Bournemouth,24,1999,21.3,28,14,5,12,11,8,30,26.7,22,16,1,15,8,36,11,0,Matches
286,Luca Koleosho,it ITA,"MF,FW",Burnley,18,2004,10.8,7,4,2,5,0,2,10,20.0,8,13,0,13,2,9,0,0,Matches
287,Ibrahima Konaté,fr FRA,DF,Liverpool,24,1999,17.5,36,22,22,13,1,18,24,75.0,6,18,12,6,20,56,51,1,Matches
288,Ezri Konsa,eng ENG,DF,Aston Villa,25,1997,34.1,54,32,28,23,3,23,27,85.2,4,36,20,16,28,82,73,3,Matches
289,Cheikhou Kouyaté,sn SEN,MF,Nott'ham Forest,33,1989,2.4,8,5,3,3,2,1,4,25.0,3,4,1,3,2,10,10,0,Matches
290,Mateo Kovačić,hr CRO,MF,Manchester City,29,1994,17.2,36,25,16,15,5,18,28,64.3,10,23,1,22,10,46,10,0,Matches
291,Emil Krafth,se SWE,DF,Newcastle Utd,28,1994,10.1,21,14,10,7,4,12,25,48.0,13,8,3,5,9,30,21,0,Matches
292,Mohammed Kudus,gh GHA,"FW,MF",West Ham,22,2000,27.6,65,47,27,27,11,20,40,50.0,20,25,0,25,11,76,9,1,Matches
293,Dejan Kulusevski,se SWE,"FW,MF",Tottenham,23,2000,30.7,62,33,19,20,23,25,67,37.3,42,24,1,23,18,80,2,1,Matches
294,Adam Lallana,eng ENG,"MF,FW",Brighton,35,1988,9.4,8,3,4,4,0,0,4,0.0,4,2,1,1,3,11,1,0,Matches
295,Tariq Lamptey,gh GHA,"DF,FW",Brighton,22,2000,10.2,21,14,14,5,2,13,22,59.1,9,7,3,4,6,27,6,0,Matches
296,Aymeric Laporte,es ESP,DF,Manchester City,29,1994,0.1,0,0,0,0,0,0,0,,0,1,1,0,0,0,1,0,Matches
297,Yasser Larouci,dz ALG,DF,Sheffield Utd,22,2001,5.9,17,9,10,5,2,10,14,71.4,4,6,1,5,7,24,20,1,Matches
298,Jamaal Lascelles,eng ENG,DF,Newcastle Utd,29,1993,12.0,14,9,7,7,0,6,11,54.5,5,17,12,5,5,19,42,0,Matches
299,Roméo Lavia,be BEL,MF,Chelsea,19,2004,0.4,1,0,0,1,0,0,0,,0,0,0,0,0,1,1,0,Matches
300,Mario Lemina,ga GAB,MF,Wolves,29,1993,33.0,90,58,46,33,11,25,47,53.2,22,36,9,27,41,131,64,0,Matches
301,Clément Lenglet,fr FRA,DF,Aston Villa,28,1995,12.8,13,9,7,5,1,7,13,53.8,6,19,11,8,7,20,47,1,Matches
302,Bernd Leno,de GER,GK,Fulham,31,1992,38.0,0,0,0,0,0,0,0,,0,0,0,0,0,0,14,1,Matches
303,Jefferson Lerma,co COL,"MF,DF",Crystal Palace,28,1994,26.7,42,25,15,23,4,19,40,47.5,21,31,12,19,36,78,72,0,Matches
304,Rico Lewis,eng ENG,"DF,MF",Manchester City,18,2004,9.0,10,7,4,4,2,3,7,42.9,4,7,1,6,4,14,6,0,Matches
305,Keane Lewis-Potter,eng ENG,"FW,DF",Brentford,22,2001,16.0,17,7,5,11,1,7,15,46.7,8,10,2,8,7,24,23,0,Matches
306,Victor Lindelöf,se SWE,DF,Manchester Utd,29,1994,14.8,15,10,8,7,0,5,13,38.5,8,18,9,9,12,27,40,1,Matches
307,Valentino Livramento,eng ENG,DF,Newcastle Utd,20,2002,14.6,23,13,15,6,2,10,21,47.6,11,16,7,9,25,48,41,1,Matches
308,Giovani Lo Celso,ar ARG,MF,Tottenham,27,1996,5.6,22,13,10,8,4,9,14,64.3,5,4,1,3,5,27,2,0,Matches
309,Tom Lockyer,wls WAL,DF,Luton Town,28,1994,13.0,25,16,17,6,2,15,22,68.2,7,23,13,10,23,48,68,0,Matches
310,Sean Longstaff,eng ENG,MF,Newcastle Utd,25,1997,30.5,54,30,17,29,8,24,63,38.1,39,43,7,36,17,71,23,0,Matches
311,Max Lowe,eng ENG,"DF,MF",Sheffield Utd,26,1997,5.6,21,10,13,5,3,8,15,53.3,7,10,4,6,5,26,15,0,Matches
312,Douglas Luiz,br BRA,MF,Aston Villa,25,1998,33.3,58,38,21,27,10,25,53,47.2,28,32,8,24,23,81,18,2,Matches
313,Saša Lukić,rs SRB,MF,Fulham,26,1996,12.5,33,19,9,17,7,18,39,46.2,21,18,5,13,16,49,19,1,Matches
314,Ian Maatsen,nl NED,"FW,MF",Chelsea,21,2002,2.3,3,2,1,1,1,0,4,0.0,4,4,0,4,3,6,10,0,Matches
315,Alexis Mac Allister,ar ARG,MF,Liverpool,24,1998,28.9,99,55,35,50,14,59,125,47.2,66,65,8,57,35,134,25,1,Matches
316,James Maddison,eng ENG,MF,Tottenham,26,1996,23.7,33,19,5,18,10,15,29,51.7,14,15,3,12,13,46,10,1,Matches
317,Noni Madueke,eng ENG,FW,Chelsea,21,2002,11.7,16,10,8,4,4,11,34,32.4,23,11,0,11,4,20,14,0,Matches
318,Gabriel Magalhães,br BRA,DF,Arsenal,25,1997,33.8,48,28,24,22,2,17,22,77.3,5,44,33,11,31,79,100,1,Matches
319,Harry Maguire,eng ENG,DF,Manchester Utd,30,1993,18.4,24,17,14,10,0,12,22,54.5,10,33,24,9,25,49,83,1,Matches
320,Kobbie Mainoo,eng ENG,MF,Manchester Utd,18,2005,21.4,47,27,20,16,11,21,45,46.7,24,20,12,8,22,69,30,1,Matches
321,Orel Mangala,be BEL,MF,Nott'ham Forest,25,1998,17.4,27,13,16,10,1,14,29,48.3,15,12,6,6,26,53,32,0,Matches
322,Benson Manuel,ao ANG,"MF,FW",Burnley,26,1997,1.3,3,2,2,1,0,0,0,,0,1,0,1,0,3,0,0,Matches
323,Solly March,eng ENG,"FW,DF",Brighton,29,1994,6.2,19,14,9,7,3,8,14,57.1,6,5,0,5,11,30,8,0,Matches
324,Anthony Martial,fr FRA,FW,Manchester Utd,27,1995,5.0,4,1,1,1,2,1,1,100.0,0,4,0,4,0,4,3,0,Matches
325,Gabriel Martinelli,br BRA,FW,Arsenal,22,2001,22.4,30,24,9,12,9,13,32,40.6,19,23,1,22,5,35,9,1,Matches
326,Emiliano Martínez,ar ARG,GK,Aston Villa,30,1992,33.5,0,0,0,0,0,0,0,,0,0,0,0,0,0,12,3,Matches
327,Lisandro Martínez,ar ARG,DF,Manchester Utd,25,1998,7.2,12,8,8,4,0,5,12,41.7,7,10,8,2,5,17,26,0,Matches
328,Han-Noah Massengo,fr FRA,"MF,DF",Burnley,22,2001,0.2,1,1,1,0,0,0,0,,0,1,0,1,0,1,0,0,Matches
329,Pape Matar Sarr,sn SEN,MF,Tottenham,20,2002,23.0,34,24,11,17,6,15,36,41.7,21,21,5,16,31,65,28,1,Matches
330,Jean-Philippe Mateta,fr FRA,FW,Crystal Palace,26,1997,25.4,22,15,4,11,7,6,10,60.0,4,13,4,9,4,26,14,0,Matches
331,Joël Matip,cm CMR,DF,Liverpool,31,1991,8.7,12,6,7,4,1,8,12,66.7,4,16,12,4,9,21,43,0,Matches
332,Alex Matos,eng ENG,MF,Chelsea,18,2004,0.0,0,0,0,0,0,0,0,,0,0,0,0,0,0,0,0,Matches
333,Remi Matthews,eng ENG,GK,Crystal Palace,29,1994,0.0,0,0,0,0,0,0,0,,0,0,0,0,0,0,1,0,Matches
334,Neal Maupay,fr FRA,FW,Brentford,26,1996,14.7,10,7,4,5,1,3,13,23.1,10,11,0,11,2,12,3,0,Matches
335,Neal Maupay,fr FRA,FW,Everton,26,1996,1.2,0,0,0,0,0,0,1,0.0,1,2,0,2,0,0,1,0,Matches
336,Konstantinos Mavropanos,gr GRE,DF,West Ham,25,1997,16.7,28,16,17,9,2,17,21,81.0,4,21,13,8,23,51,79,3,Matches
337,Bryan Mbeumo,cm CMR,FW,Brentford,23,1999,21.8,15,10,6,6,3,5,19,26.3,14,26,2,24,7,22,13,0,Matches
338,James Mcatee,eng ENG,"MF,FW",Sheffield Utd,20,2002,20.2,32,21,9,13,10,13,33,39.4,20,20,0,20,11,43,18,0,Matches
339,James Mcatee,eng ENG,MF,Manchester City,20,2002,0.0,0,0,0,0,0,0,0,,0,1,0,1,0,0,0,0,Matches
340,Oliver McBurnie,sct SCO,FW,Sheffield Utd,27,1996,14.2,17,7,4,7,6,5,12,41.7,7,18,2,16,5,22,28,0,Matches
341,James McConnell,eng ENG,MF,Liverpool,18,2004,0.0,0,0,0,0,0,0,0,,0,1,0,1,1,1,0,0,Matches
342,John McGinn,sct SCO,"MF,FW",Aston Villa,28,1994,33.3,59,35,18,34,7,32,77,41.6,45,33,4,29,21,80,21,0,Matches
343,Scott McKenna,sct SCO,DF,Nott'ham Forest,26,1996,4.6,4,0,3,1,0,2,3,66.7,1,6,4,2,5,9,27,0,Matches
344,Dwight McNeil,eng ENG,"MF,FW",Everton,23,1999,32.1,44,27,16,14,14,24,55,43.6,31,44,7,37,22,66,37,0,Matches
345,Scott McTominay,sct SCO,"MF,FW",Manchester Utd,26,1996,21.1,49,25,23,24,2,22,33,66.7,11,34,12,22,14,63,54,0,Matches
346,Ben Mee,eng ENG,DF,Brentford,33,1989,14.1,26,15,12,12,2,17,22,77.3,5,21,13,8,13,39,63,1,Matches
347,Hannibal Mejbri,tn TUN,"MF,FW",Manchester Utd,20,2003,1.5,3,3,1,2,0,1,3,33.3,2,1,1,0,0,3,0,0,Matches
348,Teden Mengi,eng ENG,DF,Luton Town,21,2002,27.4,54,22,33,20,1,19,30,63.3,11,39,27,12,57,111,140,1,Matches
349,Chris Mepham,wls WAL,DF,Bournemouth,25,1997,6.9,12,11,9,3,0,9,14,64.3,5,13,6,7,7,19,30,1,Matches
350,Lewis Miley,eng ENG,MF,Newcastle Utd,17,2006,13.4,33,21,6,20,7,15,32,46.9,17,20,3,17,8,41,18,2,Matches
351,James Milner,eng ENG,"DF,MF",Brighton,37,1986,8.6,20,14,9,10,1,9,14,64.3,5,9,0,9,8,28,16,0,Matches
352,Tyrone Mings,eng ENG,DF,Aston Villa,30,1993,0.3,0,0,0,0,0,0,0,,0,0,0,0,1,1,1,0,Matches
353,Tyrick Mitchell,eng ENG,"DF,MF",Crystal Palace,23,1999,35.6,105,60,75,21,9,43,60,71.7,17,63,10,53,26,131,104,0,Matches
354,Kaoru Mitoma,jp JPN,FW,Brighton,26,1997,16.5,13,6,3,7,3,5,19,26.3,14,15,1,14,5,18,12,0,Matches
355,Aleksandar Mitrović,rs SRB,FW,Fulham,28,1994,0.4,0,0,0,0,0,0,0,,0,0,0,0,0,0,0,0,Matches
356,Jakub Moder,pl POL,"MF,DF",Brighton,24,1999,6.9,19,10,9,5,5,9,18,50.0,9,8,2,6,2,21,12,0,Matches
357,Gonzalo Montiel,ar ARG,DF,Nott'ham Forest,26,1997,8.9,22,19,12,8,2,16,29,55.2,13,8,3,5,9,31,31,1,Matches
358,Kieffer Moore,wls WAL,"FW,MF",Bournemouth,30,1992,1.2,0,0,0,0,0,0,0,,0,0,0,0,0,0,0,0,Matches
359,Mikey Moore,eng ENG,MF,Tottenham,15,2007,0.0,0,0,0,0,0,0,0,,0,0,0,0,0,0,1,0,Matches
360,Álex Moreno,es ESP,DF,Aston Villa,30,1993,11.5,18,12,18,0,0,12,19,63.2,7,11,2,9,13,31,37,0,Matches
361,Carlton Morris,eng ENG,"FW,MF",Luton Town,27,1995,31.8,15,8,4,6,5,9,15,60.0,6,24,5,19,1,16,53,0,Matches
362,Mason Mount,eng ENG,"MF,FW",Manchester Utd,24,1999,5.7,22,14,6,10,6,6,16,37.5,10,6,1,5,6,28,3,0,Matches
363,Divin Mubama,eng ENG,FW,West Ham,18,2004,0.9,0,0,0,0,0,0,0,,0,0,0,0,0,0,0,0,Matches
364,Mykhailo Mudryk,ua UKR,FW,Chelsea,22,2001,17.5,21,12,9,7,5,10,32,31.3,22,14,1,13,9,30,9,0,Matches
365,Rodrigo Muniz,br BRA,FW,Fulham,22,2001,17.7,7,3,1,5,1,1,6,16.7,5,9,3,6,6,13,20,0,Matches
366,Daniel Muñoz,co COL,"DF,MF",Crystal Palace,27,1996,16.0,55,35,31,14,10,19,38,50.0,19,29,7,22,24,79,47,0,Matches
367,Finley Munroe,eng ENG,MF,Aston Villa,18,2005,0.0,0,0,0,0,0,0,0,,0,0,0,0,0,0,0,0,Matches
368,Arijanet Muric,xk KVX,GK,Burnley,24,1998,10.0,1,1,1,0,0,1,1,100.0,0,0,0,0,0,1,10,4,Matches
369,Murillo,br BRA,DF,Nott'ham Forest,21,2002,31.0,50,31,36,13,1,19,33,57.6,14,41,24,17,37,87,188,0,Matches
370,Alex Murphy,ie IRL,"DF,FW",Newcastle Utd,19,2004,0.1,1,1,0,1,0,1,2,50.0,1,1,0,1,1,2,0,0,Matches
371,Jacob Murphy,eng ENG,"FW,DF",Newcastle Utd,28,1995,13.2,20,10,8,4,8,12,26,46.2,14,17,0,17,6,26,16,0,Matches
372,Vitaliy Mykolenko,ua UKR,DF,Everton,24,1999,27.4,69,38,46,21,2,41,66,62.1,25,36,11,25,36,105,92,0,Matches
373,Marvelous Nakamba,zw ZIM,MF,Luton Town,29,1994,12.6,40,24,24,14,2,24,42,57.1,18,23,6,17,11,51,11,1,Matches
374,Michael Ndiweni,eng ENG,FW,Newcastle Utd,19,2003,0.0,0,0,0,0,0,0,0,,0,0,0,0,0,0,0,0,Matches
375,Reiss Nelson,eng ENG,FW,Arsenal,23,1999,3.0,9,6,5,1,3,8,10,80.0,2,5,1,4,1,10,5,0,Matches
376,Zack Nelson,eng ENG,"MF,DF",Luton Town,18,2004,0.1,1,0,1,0,0,0,0,,0,0,0,0,0,1,0,0,Matches
377,Neto,br BRA,GK,Bournemouth,34,1989,32.0,0,0,0,0,0,0,0,,0,1,0,1,1,1,12,3,Matches
378,Pedro Neto,pt POR,"FW,MF",Wolves,23,2000,16.8,7,3,3,2,2,5,15,33.3,10,5,1,4,5,12,2,0,Matches
379,Moussa Niakhate,sn SEN,DF,Nott'ham Forest,27,1996,16.2,42,25,33,9,0,20,25,80.0,5,19,12,7,14,56,51,0,Matches
380,Eddie Nketiah,eng ENG,FW,Arsenal,24,1999,12.0,12,7,2,6,4,2,7,28.6,5,11,0,11,4,16,4,0,Matches
381,Christopher Nkunku,fr FRA,"FW,MF",Chelsea,25,1997,4.9,5,4,0,4,1,1,2,50.0,1,4,1,3,2,7,4,0,Matches
382,Rhys Norrington-Davies,wls WAL,DF,Sheffield Utd,24,1999,1.2,1,1,1,0,0,0,1,0.0,1,2,0,2,1,2,2,0,Matches
383,Oliver Norwood,nir NIR,MF,Sheffield Utd,32,1991,16.0,41,26,18,18,5,20,47,42.6,27,24,9,15,21,62,39,0,Matches
384,Matheus Nunes,pt POR,MF,Wolves,24,1998,2.0,3,1,3,0,0,2,6,33.3,4,0,0,0,6,9,1,0,Matches
385,Matheus Nunes,pt POR,MF,Manchester City,24,1998,7.3,10,4,1,7,2,5,16,31.3,11,7,1,6,1,11,8,1,Matches
386,Darwin Núñez,uy URU,FW,Liverpool,24,1999,22.7,22,12,2,10,10,11,23,47.8,12,18,6,12,3,25,9,0,Matches
387,Ethan Nwaneri,eng ENG,FW,Arsenal,16,2007,0.2,0,0,0,0,0,0,0,,0,1,0,1,0,0,0,0,Matches
388,Christian Nørgaard,dk DEN,MF,Brentford,29,1994,27.8,81,50,42,31,8,32,87,36.8,55,48,6,42,54,135,50,0,Matches
389,Mark O'Mahony,ie IRL,FW,Brighton,18,2005,0.7,1,0,1,0,0,1,2,50.0,1,2,1,1,0,1,1,0,Matches
390,Dara O'Shea,ie IRL,DF,Burnley,24,1999,32.1,39,20,22,14,3,11,26,42.3,15,41,30,11,35,74,158,2,Matches
391,Michael Obafemi,ie IRL,"FW,MF",Burnley,23,2000,0.2,0,0,0,0,0,0,0,,0,1,0,1,0,0,0,0,Matches
392,Wilson Odobert,fr FRA,"MF,FW",Burnley,18,2004,23.3,17,13,8,5,4,6,22,27.3,16,26,2,24,6,23,14,0,Matches
393,Odeluga Offiah,eng ENG,DF,Brighton,20,2002,1.4,1,0,1,0,0,1,1,100.0,0,0,0,0,1,2,0,0,Matches
394,Chiedozie Ogbene,ie IRL,"MF,DF",Luton Town,26,1997,22.2,17,10,10,7,0,12,22,54.5,10,14,3,11,7,24,34,2,Matches
395,Angelo Ogbonna,it ITA,DF,West Ham,35,1988,7.1,11,5,9,2,0,6,7,85.7,1,13,10,3,3,14,29,0,Matches
396,Michael Olakigbe,eng ENG,"DF,FW",Brentford,19,2004,0.7,3,0,2,1,0,2,4,50.0,2,7,0,7,1,4,0,1,Matches
397,Michael Olise,fr FRA,"FW,MF",Crystal Palace,21,2001,14.2,19,10,7,10,2,8,24,33.3,16,21,0,21,11,30,9,0,Matches
398,Robin Olsen,se SWE,GK,Aston Villa,33,1990,4.5,0,0,0,0,0,0,0,,0,0,0,0,0,0,1,0,Matches
399,Andrew Omobamidele,ie IRL,DF,Nott'ham Forest,21,2002,8.7,10,3,9,1,0,5,8,62.5,3,12,8,4,13,23,42,1,Matches
400,Amadou Onana,be BEL,MF,Everton,21,2001,23.2,71,38,32,31,8,21,42,50.0,21,25,6,19,21,92,31,0,Matches
401,André Onana,cm CMR,GK,Manchester Utd,27,1996,38.0,2,0,2,0,0,2,2,100.0,0,0,0,0,0,2,11,2,Matches
402,Ryan One,sct SCO,FW,Sheffield Utd,17,2006,0.1,0,0,0,0,0,0,0,,0,0,0,0,0,0,0,0,Matches
403,Tyler Onyango,eng ENG,MF,Everton,20,2003,0.0,0,0,0,0,0,0,0,,0,0,0,0,0,0,0,0,Matches
404,Fred Onyedinma,eng ENG,"DF,MF",Luton Town,26,1996,4.5,10,6,7,3,0,5,12,41.7,7,3,0,3,1,11,13,0,Matches
405,Frank Onyeka,ng NGA,MF,Brentford,25,1998,12.9,37,24,9,23,5,16,29,55.2,13,15,7,8,23,60,17,0,Matches
406,Divock Origi,be BEL,FW,Nott'ham Forest,28,1995,6.7,6,4,5,0,1,0,0,,0,6,0,6,2,8,4,0,Matches
407,Stefan Ortega,de GER,GK,Manchester City,30,1992,7.1,0,0,0,0,0,0,0,,0,0,0,0,0,0,2,1,Matches
408,Ben Osborn,eng ENG,"DF,MF",Sheffield Utd,28,1994,15.2,22,9,11,9,2,8,17,47.1,9,18,2,16,8,30,30,0,Matches
409,Gabriel Osho,ng NGA,DF,Luton Town,24,1998,20.5,41,22,21,19,1,16,27,59.3,11,37,20,17,31,72,92,0,Matches
410,William Osula,dk DEN,FW,Sheffield Utd,19,2003,8.7,2,2,1,0,1,1,2,50.0,1,3,1,2,2,4,9,0,Matches
411,Dango Ouattara,bf BFA,"FW,DF",Bournemouth,21,2002,13.7,45,27,22,11,12,19,34,55.9,15,18,3,15,22,67,35,0,Matches
412,David Ozoh,eng ENG,"MF,DF",Crystal Palace,18,2005,1.7,10,6,3,6,1,5,6,83.3,1,2,0,2,0,10,2,0,Matches
413,João Palhinha,pt POR,MF,Fulham,28,1995,30.0,152,75,80,60,12,103,152,67.8,49,57,9,48,46,198,58,0,Matches
414,Cole Palmer,eng ENG,"FW,MF",Chelsea,21,2002,29.0,23,12,9,6,8,8,19,42.1,11,20,2,18,20,43,13,2,Matches
415,Cole Palmer,eng ENG,MF,Manchester City,21,2002,0.1,0,0,0,0,0,0,0,,0,0,0,0,0,0,0,0,Matches
416,Emerson Palmieri,it ITA,DF,West Ham,28,1994,34.9,106,68,48,42,16,57,90,63.3,33,47,15,32,43,149,96,0,Matches
417,Lucas Paquetá,br BRA,"FW,MF",West Ham,25,1997,29.1,71,48,38,26,7,25,52,48.1,27,28,1,27,21,92,28,2,Matches
418,Ben Parkinson,eng ENG,FW,Newcastle Utd,18,2005,0.3,0,0,0,0,0,0,0,,0,1,0,1,0,0,1,0,Matches
419,Thomas Partey,gh GHA,"MF,DF",Arsenal,30,1993,8.8,14,11,9,4,1,5,10,50.0,5,9,3,6,11,25,9,0,Matches
420,Nathan Patterson,sct SCO,DF,Everton,21,2001,11.2,34,24,21,11,2,14,37,37.8,23,14,3,11,9,43,33,0,Matches
421,Myles Peart-Harris,eng ENG,"DF,MF",Brentford,20,2002,0.1,0,0,0,0,0,0,0,,0,0,0,0,0,0,1,0,Matches
422,Sydie Peck,eng ENG,MF,Sheffield Utd,18,2004,0.1,0,0,0,0,0,0,0,,0,0,0,0,0,0,0,0,Matches
423,Facundo Pellistri,uy URU,"FW,MF",Manchester Utd,21,2001,1.9,5,3,4,1,0,1,3,33.3,2,7,1,6,1,6,5,0,Matches
424,Andreas Pereira,br BRA,MF,Fulham,27,1996,29.0,25,12,4,12,9,11,41,26.8,30,16,2,14,4,29,12,0,Matches
425,Ivan Perišić,hr CRO,FW,Tottenham,34,1989,1.1,3,2,1,1,1,3,5,60.0,2,1,0,1,2,5,1,0,Matches
426,Đorđe Petrović,rs SRB,GK,Chelsea,23,1999,22.1,0,0,0,0,0,0,0,,0,0,0,0,0,0,12,3,Matches
427,Kalvin Phillips,eng ENG,MF,West Ham,27,1995,3.4,11,6,2,8,1,5,9,55.6,4,4,1,3,4,15,2,1,Matches
428,Kalvin Phillips,eng ENG,MF,Manchester City,27,1995,1.0,3,3,1,1,1,0,0,,0,0,0,0,2,5,2,0,Matches
429,Jaden Philogene Bidace,eng ENG,FW,Aston Villa,21,2002,0.0,0,0,0,0,0,0,0,,0,0,0,0,0,0,0,0,Matches
430,Jordan Pickford,eng ENG,GK,Everton,29,1994,38.0,1,0,1,0,0,1,1,100.0,0,3,0,3,0,1,19,1,Matches
431,Ethan Pinnock,jm JAM,DF,Brentford,30,1993,28.0,35,23,22,13,0,9,20,45.0,11,40,24,16,43,78,170,3,Matches
432,Nick Pope,eng ENG,GK,Newcastle Utd,31,1992,14.9,0,0,0,0,0,0,1,0.0,1,0,0,0,0,0,7,2,Matches
433,Pedro Porro,es ESP,DF,Tottenham,23,1999,34.3,91,63,43,34,14,62,120,51.7,58,63,18,45,34,125,102,3,Matches
434,Jarell Quansah,eng ENG,DF,Liverpool,20,2003,13.2,25,22,17,7,1,14,20,70.0,6,16,8,8,17,42,39,1,Matches
435,Ionuț Radu,ro ROU,GK,Bournemouth,26,1997,2.0,0,0,0,0,0,0,0,,0,0,0,0,0,0,0,0,Matches
436,Jesurun Rak Sakyi,eng ENG,"MF,FW",Crystal Palace,20,2002,1.5,4,1,3,1,0,2,3,66.7,1,2,0,2,3,7,1,0,Matches
437,Aaron Ramsdale,eng ENG,GK,Arsenal,25,1998,6.0,0,0,0,0,0,0,0,,0,0,0,0,0,0,3,2,Matches
438,Aaron Ramsey,eng ENG,"MF,FW",Burnley,20,2003,5.9,17,14,7,5,5,8,16,50.0,8,11,2,9,1,18,10,0,Matches
439,Jacob Ramsey,eng ENG,"FW,MF",Aston Villa,22,2001,9.5,16,8,7,6,3,5,15,33.3,10,15,2,13,3,19,8,0,Matches
440,Marcus Rashford,eng ENG,FW,Manchester Utd,25,1997,25.2,19,12,9,4,6,9,26,34.6,17,15,1,14,4,23,21,0,Matches
441,David Raya,es ESP,GK,Arsenal,27,1995,32.0,1,1,1,0,0,1,1,100.0,0,0,0,0,0,1,8,5,Matches
442,Tim Ream,us USA,DF,Fulham,35,1987,16.7,20,9,13,5,2,9,18,50.0,9,23,15,8,25,45,61,2,Matches
443,Nathan Redmond,eng ENG,"FW,MF",Burnley,29,1994,1.6,2,1,0,0,2,1,4,25.0,3,1,0,1,0,2,3,0,Matches
444,Harrison Reed,eng ENG,MF,Fulham,28,1995,14.7,29,18,9,17,3,13,31,41.9,18,19,9,10,11,40,24,0,Matches
445,Sergio Reguilón,es ESP,DF,Manchester Utd,26,1996,4.6,13,8,6,2,5,8,17,47.1,9,10,0,10,5,18,7,0,Matches
446,Sergio Reguilón,es ESP,DF,Brentford,26,1996,12.4,45,20,26,18,1,24,40,60.0,16,23,6,17,16,61,41,1,Matches
447,Bobby Reid,jm JAM,FW,Fulham,30,1993,15.8,22,14,5,15,2,4,16,25.0,12,24,2,22,5,27,14,0,Matches
448,Gio Reyna,us USA,"FW,MF",Nott'ham Forest,20,2002,2.6,7,3,4,0,3,3,6,50.0,3,3,0,3,2,9,0,0,Matches
449,Rodrigo Ribeiro,pt POR,"MF,FW",Nott'ham Forest,18,2005,0.2,0,0,0,0,0,0,1,0.0,1,1,0,1,1,1,0,0,Matches
450,Declan Rice,eng ENG,MF,Arsenal,24,1999,35.8,83,51,37,38,8,32,57,56.1,25,37,11,26,44,127,52,0,Matches
451,Chris Richards,us USA,"DF,MF",Crystal Palace,23,2000,23.3,46,28,21,22,3,20,30,66.7,10,32,12,20,27,73,109,0,Matches
452,Richarlison,br BRA,FW,Tottenham,26,1997,16.6,16,11,4,8,4,2,10,20.0,8,32,6,26,8,24,23,0,Matches
453,Jaïro Riedewald,nl NED,"MF,FW",Crystal Palace,26,1996,2.6,9,3,2,4,3,3,6,50.0,3,0,0,0,2,11,2,0,Matches
454,Matt Ritchie,sct SCO,"FW,MF",Newcastle Utd,33,1989,1.4,5,3,2,2,1,2,4,50.0,2,3,2,1,1,6,5,0,Matches
455,Connor Roberts,wls WAL,DF,Burnley,27,1995,9.1,12,5,6,4,2,8,17,47.1,9,8,6,2,4,16,25,2,Matches
456,Andrew Robertson,sct SCO,DF,Liverpool,29,1994,18.8,35,24,21,11,3,26,43,60.5,17,20,6,14,13,48,40,0,Matches
457,Antonee Robinson,us USA,DF,Fulham,25,1997,36.3,93,58,60,26,7,52,110,47.3,58,56,8,48,80,173,117,3,Matches
458,Jack Robinson,eng ENG,DF,Sheffield Utd,29,1993,32.1,43,28,29,14,0,25,39,64.1,14,49,33,16,33,76,132,2,Matches
459,Rodri,es ESP,MF,Manchester City,27,1996,32.6,70,43,25,33,12,29,60,48.3,31,32,8,24,26,96,41,4,Matches
460,Jay Rodriguez,eng ENG,FW,Burnley,34,1989,9.1,14,9,7,4,3,7,13,53.8,6,11,1,10,1,15,8,0,Matches
461,Mads Roerslev,dk DEN,DF,Brentford,24,1999,22.1,48,31,34,9,5,27,54,50.0,27,15,3,12,19,67,71,0,Matches
462,Morgan Rogers,eng ENG,"MF,FW",Aston Villa,21,2002,7.1,8,1,3,2,3,2,11,18.2,9,11,0,11,3,11,11,0,Matches
463,Cristian Romero,ar ARG,DF,Tottenham,25,1998,31.0,66,40,35,25,6,32,44,72.7,12,46,22,24,44,110,106,1,Matches
464,Joe Rothwell,eng ENG,MF,Bournemouth,28,1995,4.3,7,2,4,2,1,2,8,25.0,6,4,2,2,3,10,2,0,Matches
465,Pelly Ruddock Mpanzu,cd COD,MF,Luton Town,30,1993,12.2,13,5,6,6,1,5,9,55.6,4,15,7,8,9,22,16,3,Matches
466,José Sá,pt POR,GK,Wolves,30,1993,33.7,0,0,0,0,0,0,1,0.0,1,3,0,3,0,0,21,5,Matches
467,Dominic Sadi,eng ENG,FW,Bournemouth,19,2003,0.0,0,0,0,0,0,0,0,,0,0,0,0,0,0,0,0,Matches
468,Bukayo Saka,eng ENG,FW,Arsenal,21,2001,32.4,66,35,22,24,20,26,59,44.1,33,43,2,41,15,81,24,1,Matches
469,Mohamed Salah,eg EGY,FW,Liverpool,31,1992,28.2,17,11,1,8,8,6,21,28.6,15,19,1,18,2,19,1,0,Matches
470,William Saliba,fr FRA,DF,Arsenal,22,2001,38.0,41,26,28,12,1,20,27,74.1,7,32,17,15,29,70,81,3,Matches
471,Albert Sambi Lokonga,be BEL,MF,Luton Town,23,1999,14.5,29,18,14,12,3,17,24,70.8,7,23,13,10,11,40,14,0,Matches
472,Davinson Sánchez,co COL,DF,Tottenham,27,1996,0.9,0,0,0,0,0,0,0,,0,3,2,1,1,1,2,0,Matches
473,Robert Sánchez,es ESP,GK,Chelsea,25,1997,15.9,0,0,0,0,0,0,0,,0,0,0,0,0,0,11,3,Matches
474,Jadon Sancho,eng ENG,"FW,MF",Manchester Utd,23,2000,0.9,1,0,1,0,0,1,3,33.3,2,1,0,1,1,2,0,0,Matches
475,Ibrahim Sangaré,ci CIV,MF,Nott'ham Forest,25,1997,11.5,42,23,25,13,4,12,29,41.4,17,24,7,17,16,58,21,0,Matches
476,Andrey Santos,br BRA,MF,Nott'ham Forest,19,2004,0.1,0,0,0,0,0,0,0,,0,1,0,1,0,0,0,0,Matches
477,Pablo Sarabia,es ESP,"MF,FW",Wolves,31,1992,19.4,20,13,8,8,4,12,36,33.3,24,17,1,16,10,30,9,0,Matches
478,Dane Scarlett,eng ENG,FW,Tottenham,19,2004,0.2,1,1,0,0,1,0,1,0.0,1,0,0,0,0,1,0,0,Matches
479,Kevin Schade,de GER,"FW,MF",Brentford,21,2001,3.7,3,1,1,2,0,0,5,0.0,5,2,0,2,1,4,4,0,Matches
480,Fabian Schär,ch SUI,DF,Newcastle Utd,31,1991,33.9,42,24,27,13,2,18,40,45.0,22,50,38,12,36,78,133,1,Matches
481,Jeffrey Schlupp,gh GHA,"FW,MF",Crystal Palace,30,1992,15.0,38,24,14,16,8,9,18,50.0,9,13,2,11,8,46,24,0,Matches
482,Alex Scott,eng ENG,MF,Bournemouth,19,2003,11.3,24,15,8,10,6,12,28,42.9,16,14,4,10,12,36,18,2,Matches
483,Matz Sels,be BEL,GK,Nott'ham Forest,31,1992,16.0,0,0,0,0,0,0,0,,0,0,0,0,0,0,11,1,Matches
484,Nélson Semedo,pt POR,"DF,MF",Wolves,29,1993,34.3,79,48,52,19,8,38,64,59.4,26,44,8,36,36,115,85,1,Matches
485,Antoine Semenyo,gh GHA,FW,Bournemouth,23,2000,23.4,24,17,7,9,8,9,27,33.3,18,39,2,37,6,30,21,0,Matches
486,Marcos Senesi,ar ARG,DF,Bournemouth,26,1997,24.9,55,32,28,23,4,24,56,42.9,32,50,23,27,35,90,109,1,Matches
487,Luke Shaw,eng ENG,DF,Manchester Utd,28,1995,10.7,11,8,7,3,1,9,15,60.0,6,18,11,7,6,17,39,0,Matches
488,James Shea,eng ENG,GK,Luton Town,32,1991,0.2,0,0,0,0,0,0,0,,0,0,0,0,0,0,2,0,Matches
489,Bernardo Silva,pt POR,"MF,FW",Manchester City,28,1994,28.6,51,23,13,25,13,25,57,43.9,32,32,4,28,17,68,15,1,Matches
490,Fábio Silva,pt POR,FW,Wolves,21,2002,2.9,7,4,3,4,0,2,3,66.7,1,1,0,1,2,9,0,0,Matches
491,Thiago Silva,br BRA,DF,Chelsea,38,1984,28.1,29,15,22,6,1,20,34,58.8,14,33,24,9,26,55,153,4,Matches
492,Luis Sinisterra,co COL,"FW,MF",Bournemouth,24,1999,7.8,23,12,9,10,4,9,16,56.3,7,18,0,18,8,31,4,0,Matches
493,Oliver Skipp,eng ENG,"MF,DF",Tottenham,22,2000,7.9,18,12,9,6,3,11,18,61.1,7,12,1,11,3,21,9,0,Matches
494,Adam Smith,eng ENG,DF,Bournemouth,32,1991,23.9,37,23,18,11,8,19,39,48.7,20,28,11,17,21,58,62,0,Matches
495,Emile Smith Rowe,eng ENG,MF,Arsenal,23,2000,3.9,4,1,2,2,0,2,4,50.0,2,3,1,2,3,7,1,0,Matches
496,Cédric Soares,pt POR,DF,Arsenal,31,1991,0.7,0,0,0,0,0,0,0,,0,0,0,0,0,0,0,0,Matches
497,Dominic Solanke,eng ENG,FW,Bournemouth,25,1997,36.9,23,11,3,13,7,10,29,34.5,19,24,5,19,7,30,43,0,Matches
498,Manor Solomon,il ISR,FW,Tottenham,24,1999,2.2,3,3,1,1,1,1,2,50.0,1,4,0,4,3,6,2,0,Matches
499,Tomáš Souček,cz CZE,MF,West Ham,28,1995,31.9,53,35,24,26,3,21,47,44.7,26,55,28,27,37,90,109,0,Matches
500,Vinicius Souza,br BRA,MF,Sheffield Utd,24,1999,29.6,125,76,59,51,15,41,74,55.4,33,57,17,40,32,157,75,1,Matches
501,Jason Steele,eng ENG,GK,Brighton,32,1990,17.0,0,0,0,0,0,0,3,0.0,3,0,0,0,0,0,8,1,Matches
502,Raheem Sterling,eng ENG,"FW,MF",Chelsea,28,1994,22.0,21,10,7,8,6,12,26,46.2,14,13,0,13,13,34,9,1,Matches
503,John Stones,eng ENG,"DF,MF",Manchester City,29,1994,11.8,2,1,1,0,1,0,3,0.0,3,11,7,4,10,12,21,0,Matches
504,Thomas Strakosha,al ALB,GK,Brentford,28,1995,1.5,0,0,0,0,0,0,0,,0,0,0,0,0,0,0,0,Matches
505,Dominik Szoboszlai,hu HUN,MF,Liverpool,22,2000,23.4,32,19,12,12,8,16,50,32.0,34,37,2,35,15,47,16,1,Matches
506,Matt Targett,eng ENG,DF,Newcastle Utd,27,1995,0.9,2,0,1,1,0,1,1,100.0,0,1,0,1,0,2,2,0,Matches
507,James Tarkowski,eng ENG,DF,Everton,30,1992,38.0,61,42,46,14,1,27,48,56.3,21,82,56,26,56,117,191,2,Matches
508,Jimi Tauriainen,eng ENG,FW,Chelsea,19,2004,0.0,0,0,0,0,0,0,0,,0,0,0,0,0,0,0,0,Matches
509,Nuno Tavares,pt POR,DF,Nott'ham Forest,23,2000,5.1,11,7,9,1,1,8,9,88.9,1,6,0,6,1,12,21,0,Matches
510,Marcus Tavernier,eng ENG,FW,Bournemouth,24,1999,23.5,53,34,25,22,6,26,48,54.2,22,31,3,28,5,58,23,0,Matches
511,Charlie Taylor,eng ENG,DF,Burnley,29,1993,25.9,35,20,19,14,2,17,35,48.6,18,27,11,16,19,54,78,0,Matches
512,Kenny Tete,nl NED,DF,Fulham,27,1995,9.6,27,17,19,6,2,11,19,57.9,8,10,3,7,16,43,35,0,Matches
513,Luke Thomas,eng ENG,DF,Sheffield Utd,22,2001,10.2,20,9,13,6,1,8,14,57.1,6,23,5,18,10,30,27,0,Matches
514,Youri Tielemans,be BEL,"MF,FW",Aston Villa,26,1997,18.0,41,20,17,18,6,16,40,40.0,24,23,3,20,15,56,9,0,Matches
515,Jurriën Timber,nl NED,DF,Arsenal,22,2001,0.8,2,2,1,1,0,0,0,,0,1,0,1,0,2,1,0,Matches
516,Harry Toffolo,eng ENG,DF,Nott'ham Forest,27,1995,16.2,26,14,20,6,0,15,24,62.5,9,34,13,21,14,40,49,0,Matches
517,Takehiro Tomiyasu,jp JPN,DF,Arsenal,24,1998,12.8,20,9,15,4,1,11,18,61.1,7,10,4,6,18,38,33,0,Matches
518,James Tomkins,eng ENG,DF,Crystal Palace,34,1989,0.1,0,0,0,0,0,0,0,,0,0,0,0,1,1,0,0,Matches
519,Sandro Tonali,it ITA,MF,Newcastle Utd,23,2000,4.9,7,7,4,2,1,3,9,33.3,6,3,0,3,2,9,4,0,Matches
520,Ivan Toney,eng ENG,FW,Brentford,27,1996,16.1,15,5,2,7,6,6,14,42.9,8,5,1,4,10,25,18,0,Matches
521,Pau Torres,es ESP,DF,Aston Villa,26,1997,27.4,29,18,17,11,1,14,30,46.7,16,28,12,16,14,43,75,0,Matches
522,Andros Townsend,eng ENG,"MF,FW",Luton Town,32,1991,13.4,21,13,11,2,8,13,27,48.1,14,12,0,12,5,26,10,0,Matches
523,James Trafford,eng ENG,GK,Burnley,20,2002,28.0,2,1,2,0,0,2,2,100.0,0,0,0,0,1,3,18,1,Matches
524,Adama Traoré,es ESP,"FW,MF",Fulham,27,1996,4.2,4,3,1,2,1,3,6,50.0,3,2,0,2,1,5,2,0,Matches
525,Bénie Traoré,ci CIV,"FW,MF",Sheffield Utd,20,2002,4.3,4,2,1,2,1,0,4,0.0,4,4,1,3,1,5,1,0,Matches
526,Bertrand Traoré,bf BFA,"DF,FW",Aston Villa,27,1995,0.1,1,1,1,0,0,0,0,,0,0,0,0,0,1,1,0,Matches
527,Boubacar Traoré,ml MLI,MF,Wolves,21,2001,9.1,35,23,16,17,2,9,21,42.9,12,12,2,10,5,40,7,0,Matches
528,Mark Travers,ie IRL,GK,Bournemouth,24,1999,4.0,0,0,0,0,0,0,0,,0,0,0,0,0,0,2,0,Matches
529,Mike Trésor,be BEL,"FW,MF",Burnley,24,1999,4.7,10,6,9,1,0,8,18,44.4,10,5,0,5,1,11,1,0,Matches
530,Kieran Trippier,eng ENG,DF,Newcastle Utd,32,1990,24.8,57,27,30,16,11,37,77,48.1,40,41,8,33,24,81,57,3,Matches
531,Leandro Trossard,be BEL,"FW,MF",Arsenal,28,1994,18.3,27,16,8,9,10,9,25,36.0,16,27,1,26,8,35,6,0,Matches
532,Auston Trusty,us USA,DF,Sheffield Utd,24,1998,28.6,47,30,31,13,3,21,43,48.8,22,41,22,19,35,82,153,3,Matches
533,Kostas Tsimikas,gr GRE,DF,Liverpool,27,1996,7.5,19,13,9,6,4,9,15,60.0,6,9,1,8,6,25,10,0,Matches
534,Matt Turner,us USA,GK,Nott'ham Forest,29,1994,17.0,0,0,0,0,0,0,0,,0,0,0,0,0,0,8,4,Matches
535,Destiny Udogie,it ITA,DF,Tottenham,20,2002,26.6,68,33,41,16,11,27,49,55.1,22,27,8,19,37,105,80,5,Matches
536,Lesley Ugochukwu,fr FRA,MF,Chelsea,19,2004,3.3,14,10,4,8,2,4,10,40.0,6,6,2,4,1,15,5,0,Matches
537,Enes Ünal,tr TUR,"FW,MF",Bournemouth,26,1997,3.6,6,4,2,3,1,2,5,40.0,3,4,2,2,1,7,6,0,Matches
538,Virgil van Dijk,nl NED,DF,Liverpool,32,1991,35.3,40,23,24,13,3,12,14,85.7,2,47,34,13,39,79,144,0,Matches
539,Raphaël Varane,fr FRA,DF,Manchester Utd,30,1993,15.3,18,11,10,7,1,10,14,71.4,4,23,18,5,15,33,88,0,Matches
540,Alejo Véliz,ar ARG,FW,Tottenham,19,2003,0.6,1,0,1,0,0,0,0,,0,0,0,0,0,1,0,0,Matches
541,Joël Veltman,nl NED,DF,Brighton,31,1992,17.6,54,41,32,17,5,39,58,67.2,19,17,7,10,18,72,57,1,Matches
542,Micky van de Ven,nl NED,DF,Tottenham,22,2001,26.0,49,35,34,12,3,24,33,72.7,9,25,15,10,18,67,78,1,Matches
543,Bart Verbruggen,nl NED,GK,Brighton,20,2002,21.0,1,1,1,0,0,1,2,50.0,1,0,0,0,0,1,11,3,Matches
544,Guglielmo Vicario,it ITA,GK,Tottenham,26,1996,38.0,0,0,0,0,0,0,1,0.0,1,0,0,0,1,1,31,2,Matches
545,Fabio Vieira,pt POR,"MF,FW",Arsenal,23,2000,3.3,3,2,2,0,1,3,3,100.0,0,0,0,0,2,5,2,0,Matches
546,Carlos Vinícius,br BRA,FW,Fulham,28,1995,3.5,3,2,0,1,2,0,4,0.0,4,4,0,4,0,3,1,0,Matches
547,Vitinho,br BRA,"DF,MF",Burnley,24,1999,25.7,64,34,36,22,6,43,86,50.0,43,44,6,38,12,76,47,4,Matches
548,Odisseas Vlachodimos,gr GRE,GK,Nott'ham Forest,29,1994,5.0,0,0,0,0,0,0,1,0.0,1,0,0,0,0,0,1,0,Matches
549,Kyle Walker,eng ENG,DF,Manchester City,33,1990,30.7,38,24,19,17,2,19,39,48.7,20,19,6,13,27,65,40,1,Matches
550,Aaron Wan-Bissaka,eng ENG,DF,Manchester Utd,25,1997,19.8,42,25,18,20,4,19,26,73.1,7,29,15,14,41,83,68,1,Matches
551,Joel Ward,eng ENG,DF,Crystal Palace,33,1989,22.0,45,28,26,18,1,30,47,63.8,17,17,10,7,14,59,94,1,Matches
552,James Ward-Prowse,eng ENG,MF,West Ham,28,1994,33.3,45,29,14,23,8,18,44,40.9,26,31,9,22,38,83,49,0,Matches
553,Lewis Warrington,eng ENG,FW,Everton,20,2002,0.0,0,0,0,0,0,0,0,,0,0,0,0,0,0,0,0,Matches
554,Deivid Washington,br BRA,"DF,FW",Chelsea,18,2005,0.1,1,1,1,0,0,0,1,0.0,1,0,0,0,0,1,0,0,Matches
555,Ollie Watkins,eng ENG,FW,Aston Villa,27,1995,35.7,12,7,0,5,7,5,11,45.5,6,26,4,22,4,16,20,0,Matches
556,Adam Webster,eng ENG,DF,Brighton,28,1995,12.7,14,12,8,5,1,6,18,33.3,12,16,12,4,16,30,43,1,Matches
557,Danny Welbeck,eng ENG,"FW,MF",Brighton,32,1990,18.8,35,17,9,17,9,10,17,58.8,7,12,0,12,9,44,17,1,Matches
558,Timo Werner,de GER,FW,Tottenham,27,1996,9.0,7,4,3,4,0,5,18,27.8,13,12,0,12,3,10,2,0,Matches
559,Adam Wharton,eng ENG,MF,Crystal Palace,19,2004,14.4,48,32,18,22,8,23,46,50.0,23,17,3,14,20,68,24,1,Matches
560,Ethan Wheatley,eng ENG,FW,Manchester Utd,17,2006,0.2,1,1,0,1,0,1,1,100.0,0,2,0,2,2,3,0,0,Matches
561,Ben White,eng ENG,DF,Arsenal,25,1997,33.2,48,28,20,22,6,26,58,44.8,32,48,22,26,32,80,77,1,Matches
562,Joe White,eng ENG,MF,Newcastle Utd,20,2002,0.1,1,1,1,0,0,0,0,,0,0,0,0,0,1,0,0,Matches
563,Neco Williams,wls WAL,DF,Nott'ham Forest,22,2001,18.2,69,40,42,18,9,35,56,62.5,21,44,13,31,22,91,53,0,Matches
564,Willian,br BRA,FW,Fulham,34,1988,22.8,18,11,6,7,5,3,21,14.3,18,13,0,13,9,27,12,1,Matches
565,Joe Willock,eng ENG,MF,Newcastle Utd,23,1999,4.7,13,7,7,6,0,4,11,36.4,7,7,0,7,1,14,1,0,Matches
566,Callum Wilson,eng ENG,FW,Newcastle Utd,31,1992,11.0,5,3,0,2,3,0,4,0.0,4,6,0,6,2,7,4,0,Matches
567,Harry Wilson,wls WAL,FW,Fulham,26,1997,18.0,21,14,9,8,4,11,28,39.3,17,27,3,24,10,31,12,0,Matches
568,Yoane Wissa,cd COD,FW,Brentford,26,1996,27.7,28,16,13,10,5,5,20,25.0,15,24,3,21,9,37,15,0,Matches
569,Chris Wood,nz NZL,FW,Nott'ham Forest,31,1991,20.1,7,4,1,4,2,3,9,33.3,6,11,3,8,1,8,26,0,Matches
570,Cauley Woodrow,eng ENG,"FW,MF",Luton Town,28,1994,4.7,16,10,8,4,4,9,16,56.3,7,7,1,6,1,17,14,0,Matches
571,Joe Worrall,eng ENG,DF,Nott'ham Forest,26,1997,4.9,7,5,6,1,0,3,6,50.0,3,5,4,1,3,10,32,1,Matches
572,Yehor Yarmoliuk,ua UKR,MF,Brentford,19,2004,7.6,17,11,6,8,3,7,17,41.2,10,17,4,13,6,23,5,0,Matches
573,Ryan Yates,eng ENG,MF,Nott'ham Forest,25,1997,22.1,66,40,39,21,6,20,36,55.6,16,42,15,27,21,87,44,1,Matches
574,Ashley Young,eng ENG,"DF,MF",Everton,38,1985,25.3,53,38,28,19,6,30,54,55.6,24,24,6,18,22,75,50,3,Matches
575,Illia Zabarnyi,ua UKR,DF,Bournemouth,20,2002,37.0,59,32,29,29,1,23,50,46.0,27,53,34,19,33,92,143,4,Matches
576,Nicolò Zaniolo,it ITA,"FW,MF",Aston Villa,24,1999,9.3,19,9,10,7,2,9,17,52.9,8,13,0,13,1,20,11,0,Matches
577,Anass Zaroury,ma MAR,"FW,MF",Burnley,22,2000,1.7,1,0,1,0,0,0,4,0.0,4,2,0,2,0,1,1,1,Matches
578,Oleksandr Zinchenko,ua UKR,DF,Arsenal,26,1996,19.1,50,30,19,24,7,35,52,67.3,17,18,3,15,20,70,26,2,Matches
579,Kurt Zouma,fr FRA,DF,West Ham,28,1994,31.5,23,17,14,9,0,10,16,62.5,6,38,28,10,29,52,160,0,Matches
580,Martin Ødegaard,no NOR,MF,Arsenal,24,1998,34.3,49,17,18,21,10,17,58,29.3,41,23,1,22,15,64,5,0,Matches
1,Patrick van Aanholt,nl NED,DF,Crystal Palace,27,1990,35.5,48,24,35,11,2,24,40,60.0,16,33,9,24,40,88,91,2,Matches
2,Sergio Agüero,ar ARG,FW,Manchester City,30,1988,27.3,17,9,1,10,6,5,9,55.6,4,15,1,14,9,26,3,0,Matches
3,Nathan Aké,nl NED,DF,Bournemouth,23,1995,37.9,66,35,42,21,3,22,35,62.9,13,51,35,16,32,98,241,0,Matches
4,Marc Albrighton,eng ENG,"FW,MF",Leicester City,28,1989,18.1,35,22,18,14,3,13,31,41.9,18,26,3,23,23,58,30,0,Matches
5,Toby Alderweireld,be BEL,DF,Tottenham,29,1989,32.5,37,23,25,10,2,12,22,54.5,10,41,22,19,24,61,175,0,Matches
6,Trent Alexander-Arnold,eng ENG,DF,Liverpool,19,1998,27.4,61,39,31,22,8,36,68,52.9,32,19,3,16,35,96,68,0,Matches
7,Alisson,br BRA,GK,Liverpool,25,1992,38.0,2,1,2,0,0,2,2,100.0,0,0,0,0,1,3,14,6,Matches
8,Dele Alli,eng ENG,MF,Tottenham,22,1996,20.3,33,19,6,14,13,5,24,20.8,19,33,5,28,19,52,20,0,Matches
9,Miguel Almirón,py PAR,MF,Newcastle Utd,24,1994,8.4,20,12,7,10,3,4,10,40.0,6,14,1,13,8,28,5,0,Matches
10,Marcos Alonso,es ESP,DF,Chelsea,27,1990,30.7,73,46,44,22,7,33,58,56.9,25,25,2,23,39,112,101,0,Matches
11,Daniel Amartey,gh GHA,DF,Leicester City,23,1994,7.1,18,12,11,6,1,10,15,66.7,5,6,4,2,17,35,28,1,Matches
12,Luke Amos,eng ENG,MF,Tottenham,21,1997,0.0,1,0,0,1,0,0,0,,0,0,0,0,0,1,0,0,Matches
13,Felipe Anderson,br BRA,"MF,FW",West Ham,25,1993,33.8,89,49,33,44,12,31,101,30.7,70,71,0,71,41,130,18,1,Matches
14,Florin Andone,ro ROU,FW,Brighton,25,1993,9.8,10,2,3,4,3,1,6,16.7,5,9,1,8,3,13,12,0,Matches
15,Michail Antonio,jm JAM,"MF,FW",West Ham,28,1990,23.4,23,14,12,6,5,6,12,50.0,6,38,3,35,18,41,26,1,Matches
16,Stuart Armstrong,sct SCO,MF,Southampton,26,1992,15.9,28,20,14,6,8,8,42,19.0,34,14,0,14,12,40,12,0,Matches
17,Marko Arnautović,at AUT,FW,West Ham,29,1989,22.1,9,5,4,3,2,1,7,14.3,6,4,2,2,3,12,6,0,Matches
18,Kepa Arrizabalaga,es ESP,GK,Chelsea,23,1994,36.0,1,1,1,0,0,1,2,50.0,1,1,0,1,0,1,4,2,Matches
19,Harry Arter,ie IRL,MF,Cardiff City,28,1989,22.2,62,37,27,26,9,16,46,34.8,30,33,5,28,21,83,21,2,Matches
20,Christian Atsu,gh GHA,MF,Newcastle Utd,26,1992,16.6,24,15,9,11,4,5,16,31.3,11,13,3,10,7,31,16,0,Matches
21,Pierre-Emerick Aubameyang,ga GAB,FW,Arsenal,29,1989,30.3,21,17,6,9,6,8,28,28.6,20,26,0,26,8,29,22,0,Matches
22,Serge Aurier,ci CIV,DF,Tottenham,25,1992,6.3,20,12,12,4,4,8,15,53.3,7,8,2,6,7,27,20,0,Matches
23,Charlie Austin,eng ENG,FW,Southampton,29,1989,10.9,13,7,3,6,4,6,11,54.5,5,12,2,10,2,15,13,0,Matches
24,Jordan Ayew,gh GHA,FW,Crystal Palace,26,1991,13.1,38,23,12,19,7,6,20,30.0,14,16,0,16,7,45,6,0,Matches
25,Floyd Ayité,tg TOG,"FW,MF",Fulham,29,1988,5.3,4,4,2,1,1,2,6,33.3,4,8,1,7,7,11,5,0,Matches
26,César Azpilicueta,es ESP,DF,Chelsea,28,1989,37.8,105,60,52,40,13,38,67,56.7,29,63,16,47,43,148,91,3,Matches
27,Ryan Babel,nl NED,"FW,MF",Fulham,31,1986,13.9,8,4,1,5,2,3,9,33.3,6,12,0,12,6,14,13,1,Matches
28,Juninho Bacuna,cw CUW,"MF,DF",Huddersfield,20,1997,15.7,46,29,22,19,5,22,54,40.7,32,21,1,20,24,70,12,1,Matches
29,Leandro Bacuna,cw CUW,MF,Cardiff City,26,1991,6.2,15,10,5,7,3,8,22,36.4,14,5,2,3,15,30,9,0,Matches
30,Eric Bailly,ci CIV,DF,Manchester Utd,24,1994,7.1,15,9,14,1,0,8,10,80.0,2,9,4,5,13,28,39,1,Matches
31,Leighton Baines,eng ENG,DF,Everton,33,1984,4.2,8,6,4,3,1,4,6,66.7,2,2,0,2,2,10,8,0,Matches
32,Fabián Balbuena,py PAR,DF,West Ham,26,1991,22.4,40,20,34,6,0,16,42,38.1,26,23,15,8,53,93,175,0,Matches
33,Leon Balogun,ng NGA,DF,Brighton,30,1988,6.6,12,6,11,1,0,8,9,88.9,1,5,3,2,17,29,32,1,Matches
34,Sol Bamba,ci CIV,DF,Cardiff City,33,1985,27.5,74,42,44,30,0,31,55,56.4,24,72,32,40,82,156,181,3,Matches
35,Phil Bardsley,sct SCO,DF,Burnley,33,1985,18.6,32,19,15,14,3,12,21,57.1,9,25,12,13,31,63,68,1,Matches
36,Ross Barkley,eng ENG,MF,Chelsea,24,1993,13.8,15,10,5,7,3,4,14,28.6,10,8,1,7,9,24,17,2,Matches
37,Ashley Barnes,eng ENG,FW,Burnley,28,1989,26.5,28,17,4,17,7,6,29,20.7,23,29,8,21,2,30,25,0,Matches
38,Harvey Barnes,eng ENG,"MF,FW",Leicester City,20,1997,11.2,10,6,5,4,1,4,6,66.7,2,7,1,6,3,13,7,0,Matches
39,Antonio Barreca,it ITA,DF,Newcastle Utd,23,1995,0.1,0,0,0,0,0,0,0,,0,0,0,0,0,0,0,0,Matches
40,Michy Batshuayi,be BEL,FW,Crystal Palace,24,1993,8.3,2,1,1,1,0,1,2,50.0,1,8,3,5,3,5,0,0,Matches
41,Jan Bednarek,pl POL,DF,Southampton,22,1996,23.9,41,25,25,16,0,21,37,56.8,16,44,27,17,71,112,171,0,Matches
42,Asmir Begović,ba BIH,GK,Bournemouth,31,1987,24.0,0,0,0,0,0,0,3,0.0,3,1,0,1,1,1,15,7,Matches
43,Héctor Bellerín,es ESP,DF,Arsenal,23,1995,17.0,15,12,8,4,3,6,13,46.2,7,17,5,12,20,35,37,3,Matches
44,Joe Bennett,eng ENG,DF,Cardiff City,28,1990,29.3,50,29,34,16,0,22,38,57.9,16,30,8,22,60,110,93,0,Matches
45,Ryan Bennett,eng ENG,DF,Wolves,28,1990,34.0,58,32,41,16,1,25,41,61.0,16,42,21,21,43,101,131,1,Matches
46,Christian Benteke,be BEL,FW,Crystal Palace,27,1990,9.0,5,1,0,4,1,1,4,25.0,3,7,2,5,0,5,14,0,Matches
47,Jóhann Berg Guðmundsson,is ISL,MF,Burnley,27,1990,19.5,27,11,14,10,3,16,34,47.1,18,25,4,21,33,60,34,0,Matches
48,Bernard,br BRA,"FW,MF",Everton,25,1992,23.5,49,30,19,22,8,15,55,27.3,40,37,2,35,27,76,14,1,Matches
49,Bernardo,br BRA,DF,Brighton,23,1995,19.5,62,43,43,13,6,31,45,68.9,14,32,13,19,34,96,82,0,Matches
50,Ryan Bertrand,eng ENG,DF,Southampton,28,1989,24.0,46,27,22,20,4,16,31,51.6,15,27,5,22,28,74,51,0,Matches
51,Marcus Bettinelli,eng ENG,GK,Fulham,26,1992,7.0,0,0,0,0,0,0,0,,0,0,0,0,0,0,5,0,Matches
52,Philip Billing,dk DEN,MF,Huddersfield,22,1996,24.3,73,44,26,39,8,19,42,45.2,23,57,16,41,53,126,43,0,Matches
53,Yves Bissouma,ml MLI,MF,Brighton,21,1996,19.7,62,30,33,27,2,20,38,52.6,18,21,5,16,33,95,29,2,Matches
54,Willy Boly,ci CIV,DF,Wolves,27,1991,35.2,85,52,49,34,2,34,56,60.7,22,55,32,23,72,157,177,6,Matches
55,Léo Bonatini,br BRA,FW,Wolves,24,1994,1.5,1,1,0,0,1,1,5,20.0,4,1,0,1,0,1,0,0,Matches
56,Gaëtan Bong,cm CMR,DF,Brighton,30,1988,20.1,16,10,7,6,3,6,10,60.0,4,16,6,10,25,41,57,2,Matches
57,Artur Boruc,pl POL,GK,Bournemouth,38,1980,12.0,1,0,1,0,0,1,3,33.3,2,0,0,0,0,1,1,0,Matches
58,Robbie Brady,ie IRL,MF,Burnley,26,1992,8.0,15,7,5,5,5,6,17,35.3,11,7,1,6,7,22,18,1,Matches
59,Miguel Britos,uy URU,DF,Watford,33,1985,2.1,4,2,4,0,0,2,4,50.0,2,1,1,0,3,7,11,1,Matches
60,David Brooks,wls WAL,"MF,FW",Bournemouth,21,1997,25.1,37,26,12,19,6,19,44,43.2,25,36,7,29,24,61,28,0,Matches
61,Bruno,es ESP,DF,Brighton,37,1980,12.6,25,16,20,3,2,14,18,77.8,4,7,2,5,11,36,30,1,Matches
62,Joe Bryan,eng ENG,"DF,MF",Fulham,24,1993,26.1,61,41,35,21,5,24,42,57.1,18,34,12,22,31,92,82,1,Matches
63,David Button,eng ENG,GK,Brighton,29,1989,4.0,0,0,0,0,0,0,0,,0,0,0,0,0,0,2,0,Matches
64,Willy Caballero,ar ARG,GK,Chelsea,36,1981,2.0,0,0,0,0,0,0,0,,0,0,0,0,0,0,1,0,Matches
65,Gary Cahill,eng ENG,DF,Chelsea,32,1985,0.3,0,0,0,0,0,0,0,,0,0,0,0,0,0,1,0,Matches
66,Tom Cairney,sct SCO,"MF,FW",Fulham,27,1991,24.4,37,21,9,22,6,12,16,75.0,4,21,5,16,10,47,13,1,Matches
67,Dominic Calvert-Lewin,eng ENG,FW,Everton,21,1997,19.8,13,7,3,3,7,7,15,46.7,8,16,3,13,7,20,19,0,Matches
68,Rafael Camacho,pt POR,DF,Liverpool,18,2000,0.0,1,0,1,0,0,1,1,100.0,0,0,0,0,0,1,0,0,Matches
69,Víctor Camarasa,es ESP,MF,Cardiff City,24,1994,28.5,28,15,8,15,5,6,31,19.4,25,17,2,15,33,61,28,1,Matches
70,Étienne Capoue,fr FRA,MF,Watford,30,1988,32.7,91,56,36,48,7,33,87,37.9,54,50,13,37,85,176,96,1,Matches
71,Andy Carroll,eng ENG,FW,West Ham,29,1989,5.1,4,2,1,3,0,1,4,25.0,3,3,2,1,1,5,8,0,Matches
72,Jonny Castro,es ESP,"DF,MF",Wolves,24,1994,30.8,79,43,42,33,4,31,60,51.7,29,45,8,37,60,139,64,2,Matches
73,Craig Cathcart,nir NIR,DF,Watford,29,1989,34.4,50,31,36,11,3,21,37,56.8,16,42,30,12,38,88,184,4,Matches
74,Ivan Cavaleiro,pt POR,"FW,MF",Wolves,24,1993,7.7,5,4,3,1,1,1,14,7.1,13,12,0,12,4,9,5,0,Matches
75,Petr Čech,cz CZE,GK,Arsenal,36,1982,6.5,1,1,1,0,0,1,1,100.0,0,0,0,0,0,1,5,2,Matches
76,Nathaniel Chalobah,eng ENG,MF,Watford,23,1994,3.0,3,2,1,2,0,2,7,28.6,5,2,1,1,5,8,7,0,Matches
77,Calum Chambers,eng ENG,"MF,DF",Fulham,23,1995,28.8,64,36,32,27,5,16,48,33.3,32,37,12,25,69,133,113,4,Matches
78,Ben Chilwell,eng ENG,DF,Leicester City,21,1996,36.0,55,29,34,18,3,24,55,43.6,31,37,7,30,38,93,156,0,Matches
79,Tahith Chong,nl NED,FW,Manchester Utd,18,1999,0.4,0,0,0,0,0,0,0,,0,1,0,1,0,0,1,0,Matches
80,Hamza Choudhury,eng ENG,MF,Leicester City,20,1997,6.6,24,10,13,10,1,9,15,60.0,6,12,3,9,15,39,13,0,Matches
81,Andreas Christensen,dk DEN,DF,Chelsea,22,1996,6.9,10,4,2,6,2,2,5,40.0,3,4,2,2,4,14,29,0,Matches
82,Cyrus Christie,ie IRL,"DF,MF",Fulham,25,1992,21.6,43,23,26,13,4,18,41,43.9,23,25,11,14,29,72,96,1,Matches
83,Ibrahima Cissé,gn GUI,MF,Fulham,24,1994,1.0,0,0,0,0,0,0,1,0.0,1,0,0,0,3,3,4,0,Matches
84,Ciaran Clark,ie IRL,DF,Newcastle Utd,28,1989,9.5,20,17,15,5,0,9,12,75.0,3,11,7,4,12,32,58,0,Matches
85,Tom Cleverley,eng ENG,MF,Watford,28,1989,5.3,17,9,11,4,2,6,22,27.3,16,4,0,4,5,22,11,0,Matches
86,Nathaniel Clyne,eng ENG,DF,Bournemouth,27,1991,12.7,33,18,16,14,3,11,23,47.8,12,13,3,10,16,49,33,1,Matches
87,Nathaniel Clyne,eng ENG,DF,Liverpool,27,1991,1.2,4,3,2,2,0,2,4,50.0,2,1,0,1,2,6,1,0,Matches
88,Conor Coady,eng ENG,DF,Wolves,25,1993,38.0,31,19,26,5,0,17,32,53.1,15,35,27,8,30,61,133,3,Matches
89,Joel Coleman,eng ENG,GK,Huddersfield,22,1995,1.0,0,0,0,0,0,0,0,,0,0,0,0,0,0,0,0,Matches
90,Séamus Coleman,ie IRL,DF,Everton,29,1988,28.4,44,25,23,18,3,19,30,63.3,11,14,5,9,26,70,86,0,Matches
91,Lewis Cook,eng ENG,MF,Bournemouth,21,1997,8.0,13,6,6,7,0,8,19,42.1,11,8,2,6,8,21,7,1,Matches
92,Steve Cook,eng ENG,DF,Bournemouth,27,1991,31.0,36,19,31,5,0,20,27,74.1,7,36,21,15,50,86,202,1,Matches
93,Jack Cork,eng ENG,MF,Burnley,29,1989,36.8,51,27,12,34,5,18,46,39.1,28,39,16,23,29,80,82,2,Matches
94,Hélder Costa,ao ANG,"FW,MF",Wolves,24,1994,14.9,18,14,7,7,4,7,23,30.4,16,15,0,15,9,27,6,0,Matches
95,Aaron Cresswell,eng ENG,DF,West Ham,28,1989,17.7,29,16,14,11,4,13,25,52.0,12,28,7,21,23,52,58,0,Matches
96,Peter Crouch,eng ENG,FW,Burnley,37,1981,1.0,1,1,0,1,0,1,1,100.0,0,0,0,0,0,1,2,0,Matches
97,Greg Cunningham,ie IRL,DF,Cardiff City,27,1991,7.0,18,7,11,4,3,9,16,56.3,7,9,3,6,17,35,16,1,Matches
98,Diogo Dalot,pt POR,"DF,FW",Manchester Utd,19,1999,11.3,24,12,8,14,2,14,19,73.7,5,15,2,13,10,34,35,1,Matches
99,Matty Daly,eng ENG,MF,Huddersfield,17,2001,0.8,0,0,0,0,0,0,0,,0,0,0,0,0,0,0,0,Matches
100,Loïc Damour,fr FRA,MF,Cardiff City,27,1991,0.3,0,0,0,0,0,0,1,0.0,1,0,0,0,0,0,0,0,Matches
101,Charlie Daniels,eng ENG,DF,Bournemouth,31,1986,17.6,25,15,18,6,1,13,22,59.1,9,14,4,10,20,45,56,2,Matches
102,Danilo,br BRA,DF,Manchester City,27,1991,9.0,20,16,6,12,2,12,17,70.6,5,5,0,5,15,35,22,1,Matches
103,Scott Dann,eng ENG,DF,Crystal Palace,31,1987,7.4,6,2,5,1,0,3,7,42.9,4,16,12,4,5,11,46,0,Matches
104,Matteo Darmian,it ITA,DF,Manchester Utd,28,1989,4.9,14,8,10,4,0,4,11,36.4,7,9,0,9,7,21,20,0,Matches
105,Ben Davies,wls WAL,DF,Tottenham,25,1993,20.5,56,30,39,13,4,38,54,70.4,16,23,10,13,23,79,68,1,Matches
106,Tom Davies,eng ENG,MF,Everton,20,1998,10.9,27,17,9,17,1,7,23,30.4,16,15,1,14,16,43,9,1,Matches
107,Steven Davis,nir NIR,MF,Southampton,33,1985,1.1,2,2,0,2,0,0,0,,0,2,0,2,1,3,5,0,Matches
108,Kevin De Bruyne,be BEL,MF,Manchester City,27,1991,10.8,22,15,6,12,4,7,21,33.3,14,13,1,12,3,25,2,1,Matches
109,Troy Deeney,eng ENG,FW,Watford,30,1988,28.3,24,14,8,10,6,7,32,21.9,25,22,4,18,7,31,29,0,Matches
110,Jermain Defoe,eng ENG,FW,Bournemouth,35,1982,0.3,0,0,0,0,0,0,0,,0,0,0,0,0,0,0,0,Matches
111,Steven Defour,be BEL,MF,Burnley,30,1988,5.0,8,4,2,4,2,3,14,21.4,11,11,3,8,8,16,7,0,Matches
112,Fabian Delph,eng ENG,DF,Manchester City,28,1989,8.1,23,14,11,7,5,12,23,52.2,11,3,0,3,13,36,19,1,Matches
113,Mousa Dembélé,be BEL,MF,Tottenham,31,1987,5.7,13,9,6,6,1,4,7,57.1,3,4,1,3,7,20,5,2,Matches
114,Leander Dendoncker,be BEL,MF,Wolves,23,1995,16.3,53,26,25,25,3,16,47,34.0,31,35,6,29,23,76,34,1,Matches
115,Laurent Depoitre,be BEL,FW,Huddersfield,29,1988,11.9,6,4,2,3,1,0,3,0.0,3,9,0,9,2,8,8,0,Matches
116,Gerard Deulofeu,es ESP,"FW,MF",Watford,24,1994,23.0,11,6,5,3,3,4,26,15.4,22,16,0,16,14,25,3,0,Matches
117,Fousseni Diabaté,ml MLI,FW,Leicester City,22,1995,0.6,2,0,2,0,0,0,1,0.0,1,2,0,2,0,2,0,0,Matches
118,Adama Diakhaby,fr FRA,"FW,MF",Huddersfield,22,1996,6.1,6,3,4,1,1,3,11,27.3,8,7,0,7,1,7,2,0,Matches
119,Mohamed Diamé,sn SEN,MF,Newcastle Utd,31,1987,24.1,76,46,35,36,5,16,54,29.6,38,42,9,33,30,106,39,1,Matches
120,Grady Diangana,cd COD,"MF,FW",West Ham,20,1998,6.8,20,9,8,8,4,5,14,35.7,9,11,0,11,1,21,4,0,Matches
121,Eric Dier,eng ENG,"MF,DF",Tottenham,24,1994,16.7,26,16,7,15,4,19,47,40.4,28,27,12,15,21,47,46,1,Matches
122,Lucas Digne,fr FRA,DF,Everton,25,1993,32.9,71,46,45,18,8,28,45,62.2,17,43,9,34,60,131,116,0,Matches
123,Issa Diop,fr FRA,DF,West Ham,21,1997,33.0,68,38,47,21,0,37,57,64.9,20,58,36,22,64,132,161,4,Matches
124,Matt Doherty,ie IRL,"DF,MF",Wolves,26,1992,34.9,67,42,48,15,4,35,58,60.3,23,49,7,42,60,127,107,2,Matches
125,Abdoulaye Doucouré,ml MLI,MF,Watford,25,1993,34.0,71,38,27,32,12,19,57,33.3,38,31,8,23,34,105,55,5,Matches
126,Luke Dreher,eng ENG,FW,Crystal Palace,19,1998,0.0,0,0,0,0,0,0,0,,0,0,0,0,0,0,0,0,Matches
127,Martin Dúbravka,sk SVK,GK,Newcastle Utd,29,1989,38.0,2,0,2,0,0,1,3,33.3,2,0,0,0,0,2,20,5,Matches
128,Shane Duffy,ie IRL,DF,Brighton,26,1992,34.3,35,20,23,7,5,14,25,56.0,11,57,47,10,36,71,244,3,Matches
129,Demeaco Duhaney,eng ENG,DF,Huddersfield,19,1998,0.5,1,0,1,0,0,1,3,33.3,2,2,0,2,1,2,1,0,Matches
130,Paul Dummett,wls WAL,DF,Newcastle Utd,26,1991,22.1,34,22,24,9,1,19,32,59.4,13,25,11,14,37,71,133,0,Matches
131,Lewis Dunk,eng ENG,DF,Brighton,26,1991,35.0,42,26,31,10,1,17,39,43.6,22,49,38,11,46,88,196,5,Matches
132,Erik Durm,de GER,DF,Huddersfield,26,1992,22.8,35,22,24,8,3,14,33,42.4,19,26,6,20,41,76,42,0,Matches
133,Bruno Ecuele Manga,ga GAB,DF,Cardiff City,30,1988,37.5,69,36,48,16,5,29,58,50.0,29,62,28,34,81,150,179,4,Matches
134,Ederson,br BRA,GK,Manchester City,24,1993,38.0,3,3,2,1,0,3,3,100.0,0,0,0,0,1,4,12,2,Matches
135,Harvey Elliott,eng ENG,MF,Fulham,15,2003,0.2,0,0,0,0,0,0,0,,0,1,0,1,0,0,0,0,Matches
136,Mohamed Elneny,eg EGY,MF,Arsenal,26,1992,4.2,13,4,9,1,3,1,2,50.0,1,7,4,3,2,15,8,0,Matches
137,Mohamed Elyounoussi,no NOR,MF,Southampton,23,1994,8.8,16,12,7,6,3,6,19,31.6,13,11,1,10,6,22,5,0,Matches
138,Christian Eriksen,dk DEN,MF,Tottenham,26,1992,30.8,41,25,8,20,13,17,59,28.8,42,26,3,23,15,56,13,0,Matches
139,Neil Etheridge,ph PHI,GK,Cardiff City,28,1990,38.0,1,1,1,0,0,1,2,50.0,1,0,0,0,7,8,19,1,Matches
140,Jonny Evans,nir NIR,DF,Leicester City,30,1988,22.2,24,13,20,4,0,13,18,72.2,5,28,10,18,33,57,152,3,Matches
141,Łukasz Fabiański,pl POL,GK,West Ham,33,1985,38.0,1,0,1,0,0,1,3,33.3,2,0,0,0,1,2,10,1,Matches
142,Fabinho,br BRA,MF,Liverpool,24,1993,22.4,59,31,17,38,4,24,59,40.7,35,34,6,28,28,87,27,2,Matches
143,Cesc Fàbregas,es ESP,MF,Chelsea,31,1987,2.0,6,4,4,2,0,1,5,20.0,4,2,1,1,1,7,0,0,Matches
144,Fabricio,es ESP,GK,Fulham,30,1987,2.0,1,1,1,0,0,0,0,,0,0,0,0,0,1,3,2,Matches
145,Marouane Fellaini,be BEL,MF,Manchester Utd,30,1987,8.4,21,13,11,9,1,9,17,52.9,8,9,5,4,4,25,34,1,Matches
146,Kiko Femenía,es ESP,DF,Watford,27,1991,22.8,48,30,34,12,2,24,51,47.1,27,24,6,18,36,84,68,0,Matches
147,Federico Fernández,ar ARG,DF,Newcastle Utd,29,1989,16.5,16,12,12,4,0,10,18,55.6,8,19,12,7,25,41,106,1,Matches
148,Fernandinho,br BRA,MF,Manchester City,33,1985,26.4,57,43,19,30,8,26,47,55.3,21,28,4,24,41,98,70,0,Matches
149,Roberto Firmino,br BRA,"FW,MF",Liverpool,26,1991,29.0,30,20,5,16,9,7,34,20.6,27,35,1,34,6,36,16,0,Matches
150,Phil Foden,eng ENG,MF,Manchester City,18,2000,3.7,7,6,1,3,3,2,9,22.2,7,1,0,1,4,11,1,0,Matches
151,Fraser Forster,eng ENG,GK,Southampton,30,1988,1.0,0,0,0,0,0,0,0,,0,0,0,0,0,0,1,0,Matches
152,Ben Foster,eng ENG,GK,Watford,35,1983,38.0,2,2,2,0,0,2,6,33.3,4,0,0,0,2,4,34,3,Matches
153,Timothy Fosu-Mensah,nl NED,DF,Fulham,20,1998,8.8,18,7,12,6,0,8,13,61.5,5,11,5,6,12,30,30,1,Matches
154,Juan Foyth,ar ARG,DF,Tottenham,20,1998,9.9,31,17,20,11,0,14,19,73.7,5,12,5,7,10,41,50,1,Matches
155,Simon Francis,eng ENG,DF,Bournemouth,33,1985,13.7,25,14,19,5,1,12,24,50.0,12,15,7,8,19,44,73,1,Matches
156,Ryan Fraser,sct SCO,"MF,FW",Bournemouth,24,1994,35.2,19,11,9,8,2,10,32,31.3,22,23,6,17,22,41,33,0,Matches
157,Fred,br BRA,MF,Manchester Utd,25,1993,11.6,29,17,12,16,1,15,33,45.5,18,26,2,24,16,45,14,2,Matches
158,Ryan Fredericks,eng ENG,DF,West Ham,25,1992,12.1,38,23,33,5,0,21,32,65.6,11,15,5,10,13,51,49,1,Matches
159,Christian Fuchs,at AUT,DF,Leicester City,32,1986,2.3,4,3,0,4,0,1,2,50.0,1,0,0,0,4,8,8,0,Matches
160,Manolo Gabbiadini,it ITA,"FW,MF",Southampton,26,1991,5.3,6,2,1,4,1,1,2,50.0,1,5,0,5,3,9,6,0,Matches
161,Sam Gallagher,eng ENG,FW,Southampton,22,1995,0.4,0,0,0,0,0,0,0,,0,1,0,1,0,0,1,0,Matches
162,Idrissa Gana Gueye,sn SEN,MF,Everton,28,1989,31.4,142,89,70,63,9,38,76,50.0,38,52,8,44,74,216,48,1,Matches
163,James Garner,eng ENG,MF,Manchester Utd,17,2001,0.0,0,0,0,0,0,0,0,,0,0,0,0,0,0,0,0,Matches
164,Paulo Gazzaniga,ar ARG,GK,Tottenham,26,1992,3.0,0,0,0,0,0,0,0,,0,0,0,0,0,0,1,0,Matches
165,David de Gea,es ESP,GK,Manchester Utd,27,1990,38.0,0,0,0,0,0,0,2,0.0,2,1,0,1,0,0,11,4,Matches
166,Rachid Ghezzal,dz ALG,"FW,MF",Leicester City,26,1992,8.3,14,5,3,7,4,3,18,16.7,15,10,1,9,7,21,4,1,Matches
167,Morgan Gibbs-White,eng ENG,"MF,FW",Wolves,18,2000,7.4,6,3,2,4,0,1,4,25.0,3,6,0,6,1,7,0,0,Matches
168,Ben Gibson,eng ENG,DF,Burnley,25,1993,0.7,1,1,1,0,0,0,0,,0,1,1,0,0,1,2,0,Matches
169,Olivier Giroud,fr FRA,FW,Chelsea,31,1986,9.4,3,2,0,1,2,1,4,25.0,3,6,1,5,3,6,7,0,Matches
170,André Gomes,pt POR,MF,Everton,25,1993,22.0,39,23,12,24,3,13,59,22.0,46,27,4,23,20,59,18,0,Matches
171,Angel Gomes,eng ENG,"MF,FW",Manchester Utd,17,2000,0.3,1,0,0,0,1,0,0,,0,0,0,0,0,1,0,0,Matches
172,Joe Gomez,eng ENG,DF,Liverpool,21,1997,11.8,18,11,10,7,1,9,15,60.0,6,10,5,5,14,32,42,0,Matches
173,Jon Gorenc Stanković,si SVN,"MF,DF",Huddersfield,22,1996,7.9,26,18,18,7,1,14,26,53.8,12,16,9,7,9,35,20,1,Matches
174,Dan Gosling,eng ENG,MF,Bournemouth,28,1990,19.3,57,23,27,21,9,28,53,52.8,25,33,11,22,20,77,46,1,Matches
175,Karlan Grant,eng ENG,FW,Huddersfield,20,1997,9.7,5,2,1,2,2,1,3,33.3,2,8,0,8,2,7,1,1,Matches
176,Andre Gray,jm JAM,FW,Watford,27,1991,15.2,3,1,0,2,1,1,6,16.7,5,3,1,2,2,5,6,0,Matches
177,Demarai Gray,jm JAM,"FW,MF",Leicester City,22,1996,22.1,25,12,7,14,4,6,16,37.5,10,19,0,19,9,34,15,0,Matches
178,Mason Greenwood,eng ENG,FW,Manchester Utd,16,2001,1.3,3,3,2,0,1,2,3,66.7,1,2,0,2,0,3,1,0,Matches
179,Pascal Groß,de GER,"MF,FW",Brighton,27,1991,20.7,27,12,12,12,3,11,36,30.6,25,20,8,12,13,40,23,0,Matches
180,Vicente Guaita,es ESP,GK,Crystal Palace,31,1987,19.5,0,0,0,0,0,0,0,,0,0,0,0,0,0,5,2,Matches
181,Mattéo Guendouzi,fr FRA,MF,Arsenal,19,1999,23.9,44,26,18,23,3,17,47,36.2,30,28,5,23,30,74,24,3,Matches
182,İlkay Gündoğan,de GER,MF,Manchester City,27,1990,23.7,19,12,4,12,3,6,31,19.4,25,12,3,9,28,47,19,1,Matches
183,Angus Gunn,sct SCO,GK,Southampton,22,1996,12.0,0,0,0,0,0,0,0,,0,0,0,0,0,0,8,3,Matches
184,Aron Gunnarsson,is ISL,MF,Cardiff City,29,1989,25.2,51,29,23,25,3,23,84,27.4,61,40,12,28,38,89,55,1,Matches
185,Florent Hadergjonaj,xk KVX,"DF,MF",Huddersfield,24,1994,20.5,30,17,10,18,2,13,37,35.1,24,21,7,14,21,51,37,1,Matches
186,Ben Hamer,eng ENG,GK,Huddersfield,30,1987,6.1,0,0,0,0,0,0,3,0.0,3,0,0,0,1,1,3,2,Matches
187,Kadeem Harris,eng ENG,MF,Cardiff City,25,1993,4.2,12,5,6,4,2,7,8,87.5,1,3,0,3,3,15,5,0,Matches
188,Joe Hart,eng ENG,GK,Burnley,31,1987,19.0,0,0,0,0,0,0,1,0.0,1,0,0,0,0,0,11,3,Matches
189,Isaac Hayden,eng ENG,MF,Newcastle Utd,23,1995,20.7,73,43,19,45,9,23,41,56.1,18,32,4,28,40,113,30,0,Matches
190,Eden Hazard,be BEL,FW,Chelsea,27,1991,32.5,14,9,2,1,11,5,17,29.4,12,10,0,10,13,27,6,1,Matches
191,Rhys Healey,wls WAL,FW,Cardiff City,23,1994,0.6,1,0,0,1,0,0,1,0.0,1,0,0,0,0,1,0,0,Matches
192,Tom Heaton,eng ENG,GK,Burnley,32,1986,19.0,0,0,0,0,0,0,2,0.0,2,0,0,0,0,0,8,2,Matches
193,Jordan Henderson,eng ENG,MF,Liverpool,28,1990,22.1,46,36,20,22,4,16,39,41.0,23,27,3,24,30,76,17,0,Matches
194,Jeff Hendrick,ie IRL,"MF,FW",Burnley,26,1992,22.9,24,12,13,7,4,9,32,28.1,23,20,5,15,12,36,31,0,Matches
195,Wayne Hennessey,wls WAL,GK,Crystal Palace,31,1987,17.5,0,0,0,0,0,0,2,0.0,2,0,0,0,0,0,5,1,Matches
196,Javier Hernández,mx MEX,FW,West Ham,30,1988,14.8,3,0,0,3,0,0,6,0.0,6,8,1,7,1,4,8,0,Matches
197,Ander Herrera,es ESP,MF,Manchester Utd,28,1989,15.6,54,28,24,22,8,21,61,34.4,40,38,6,32,37,91,25,1,Matches
198,Son Heung-min,kr KOR,"FW,MF",Tottenham,26,1992,22.7,23,12,7,12,4,10,34,29.4,24,26,2,24,8,31,4,1,Matches
199,Gonzalo Higuaín,ar ARG,FW,Chelsea,30,1987,12.1,10,7,2,4,4,2,11,18.2,9,4,0,4,1,11,5,0,Matches
200,Wesley Hoedt,nl NED,DF,Southampton,24,1994,13.0,28,12,23,5,0,17,26,65.4,9,20,13,7,23,51,79,2,Matches
201,Jonathan Hogg,eng ENG,MF,Huddersfield,29,1988,26.3,78,41,18,51,9,27,69,39.1,42,46,7,39,73,151,19,1,Matches
202,Junior Hoilett,ca CAN,"MF,FW",Cardiff City,28,1990,23.8,40,27,26,11,3,15,53,28.3,38,34,0,34,32,72,30,0,Matches
203,Rob Holding,eng ENG,DF,Arsenal,22,1995,9.0,11,7,9,2,0,2,8,25.0,6,9,7,2,12,23,40,0,Matches
204,José Holebas,gr GRE,DF,Watford,34,1984,26.6,68,40,44,20,4,28,53,52.8,25,27,8,19,21,89,97,0,Matches
205,Mason Holgate,eng ENG,DF,Everton,21,1996,4.5,5,4,4,1,0,1,1,100.0,0,3,2,1,3,8,32,0,Matches
206,Callum Hudson-Odoi,eng ENG,FW,Chelsea,17,2000,4.4,8,6,8,0,0,2,4,50.0,2,1,0,1,3,11,0,0,Matches
207,Will Hughes,eng ENG,MF,Watford,23,1995,26.9,74,43,27,35,12,25,59,42.4,34,55,6,49,25,99,30,0,Matches
208,Emerson Hyndman,us USA,MF,Bournemouth,22,1996,0.4,6,2,6,0,0,2,3,66.7,1,0,0,0,1,7,0,0,Matches
209,Pierre Højbjerg,dk DEN,MF,Southampton,22,1995,30.7,71,49,20,44,7,24,73,32.9,49,51,8,43,60,131,30,1,Matches
210,Jordon Ibe,eng ENG,"MF,DF",Bournemouth,22,1995,8.9,6,5,0,5,1,2,7,28.6,5,2,0,2,4,10,4,0,Matches
211,Vicente Iborra,es ESP,MF,Leicester City,30,1988,2.5,4,1,1,3,0,0,7,0.0,7,1,0,1,8,12,4,1,Matches
212,Kelechi Iheanacho,ng NGA,"FW,MF",Leicester City,21,1996,10.5,6,5,4,1,1,1,5,20.0,4,5,0,5,2,8,3,0,Matches
213,Danny Ings,eng ENG,FW,Southampton,26,1992,18.3,30,14,5,19,6,11,28,39.3,17,30,2,28,5,35,9,0,Matches
214,Alex Iwobi,ng NGA,"FW,MF",Arsenal,22,1996,21.9,28,14,10,16,2,6,25,24.0,19,21,1,20,12,40,13,1,Matches
215,José Izquierdo,co COL,"MF,FW",Brighton,26,1992,8.8,15,9,9,4,2,10,20,50.0,10,7,1,6,5,20,7,0,Matches
216,Phil Jagielka,eng ENG,DF,Everton,35,1982,3.7,7,5,3,4,0,1,4,25.0,3,1,0,1,2,9,14,0,Matches
217,Alireza Jahanbakhsh,ir IRN,"FW,MF",Brighton,24,1993,11.3,32,18,17,11,4,11,30,36.7,19,16,0,16,11,43,4,0,Matches
218,Daryl Janmaat,nl NED,DF,Watford,29,1989,16.9,36,24,23,11,2,20,29,69.0,9,16,6,10,33,69,71,0,Matches
219,Vincent Janssen,nl NED,FW,Tottenham,24,1994,0.4,2,1,0,2,0,0,0,,0,0,0,0,0,2,1,0,Matches
220,Carl Jenkinson,eng ENG,DF,Arsenal,26,1992,1.8,3,2,2,0,1,2,3,66.7,1,4,3,1,0,3,2,0,Matches
221,Gabriel Jesus,br BRA,FW,Manchester City,21,1997,11.5,10,3,5,2,3,0,5,0.0,5,16,2,14,3,13,4,0,Matches
222,Raúl Jiménez,mx MEX,FW,Wolves,27,1991,34.6,30,18,5,17,8,6,23,26.1,17,25,3,22,26,56,40,0,Matches
223,Stefan Johansen,no NOR,MF,Fulham,27,1991,4.6,11,3,4,7,0,5,8,62.5,3,5,0,5,3,14,6,0,Matches
224,Ben Johnson,eng ENG,DF,West Ham,18,2000,0.7,1,0,1,0,0,0,1,0.0,1,0,0,0,1,2,5,0,Matches
225,Tyreke Johnson,eng ENG,MF,Southampton,19,1998,0.0,0,0,0,0,0,0,0,,0,0,0,0,0,0,0,0,Matches
226,Phil Jones,eng ENG,DF,Manchester Utd,26,1992,14.0,19,13,12,7,0,8,13,61.5,5,16,11,5,23,42,67,3,Matches
227,Jorginho,it ITA,MF,Chelsea,26,1991,35.1,76,38,27,41,8,45,96,46.9,51,46,7,39,64,140,38,1,Matches
228,Joselu,es ESP,FW,Newcastle Utd,28,1990,6.6,14,8,4,5,5,4,9,44.4,5,5,0,5,3,17,15,0,Matches
229,Diogo Jota,pt POR,"FW,MF",Wolves,21,1996,26.2,28,16,11,11,6,10,38,26.3,28,20,1,19,13,41,11,0,Matches
230,Mathias Jørgensen,dk DEN,DF,Huddersfield,28,1990,23.9,49,31,27,21,1,27,46,58.7,19,29,14,15,69,118,83,0,Matches
231,Christian Kabasele,be BEL,DF,Watford,27,1991,17.6,25,14,20,5,0,10,23,43.5,13,21,16,5,38,63,111,0,Matches
232,Elias Kachunga,cd COD,"FW,MF",Huddersfield,26,1992,13.1,22,9,8,12,2,9,25,36.0,16,16,1,15,4,26,10,0,Matches
233,Aboubakar Kamara,mr MTN,FW,Fulham,23,1995,7.7,8,4,1,5,2,3,7,42.9,4,6,0,6,1,9,6,0,Matches
234,Harry Kane,eng ENG,FW,Tottenham,25,1993,26.9,10,6,2,8,0,1,14,7.1,13,16,6,10,1,11,14,0,Matches
235,N'Golo Kanté,fr FRA,MF,Chelsea,27,1991,34.4,75,41,21,41,13,23,67,34.3,44,63,6,57,44,119,32,1,Matches
236,Beram Kayal,il ISR,MF,Brighton,30,1988,10.4,28,17,16,11,1,5,21,23.8,16,17,10,7,15,43,25,0,Matches
237,Michael Keane,eng ENG,DF,Everton,25,1993,33.0,41,25,22,16,3,19,32,59.4,13,30,22,8,43,84,185,4,Matches
238,Neeskens Kebano,cd COD,"FW,MF",Fulham,26,1992,1.2,3,1,2,1,0,1,1,100.0,0,3,0,3,0,3,3,0,Matches
239,Naby Keïta,gn GUI,"MF,FW",Liverpool,23,1995,15.4,37,15,13,19,5,14,42,33.3,28,29,4,25,12,49,16,1,Matches
240,Martin Kelly,eng ENG,DF,Crystal Palace,28,1990,12.3,21,13,18,2,1,14,19,73.7,5,18,12,6,11,32,88,1,Matches
241,Kenedy,br BRA,"MF,DF",Newcastle Utd,22,1996,15.0,30,22,11,16,3,12,29,41.4,17,10,0,10,32,62,24,1,Matches
242,Jonjoe Kenny,eng ENG,DF,Everton,21,1997,8.8,21,16,16,4,1,10,18,55.6,8,13,2,11,17,38,36,1,Matches
243,Max Kilman,eng ENG,DF,Wolves,21,1997,0.0,0,0,0,0,0,0,0,,0,0,0,0,0,0,0,0,Matches
244,Joshua King,no NOR,"FW,MF",Bournemouth,26,1992,32.9,30,19,7,19,4,8,29,27.6,21,28,4,24,7,37,14,0,Matches
245,Anthony Knockaert,fr FRA,"MF,FW",Brighton,26,1991,20.4,33,21,12,15,6,13,30,43.3,17,13,0,13,29,62,11,0,Matches
246,Sead Kolašinac,ba BIH,"DF,MF",Arsenal,25,1993,21.0,34,21,21,7,6,20,34,58.8,14,12,3,9,20,54,28,3,Matches
247,Vincent Kompany,be BEL,DF,Manchester City,32,1986,13.6,16,10,11,3,2,8,9,88.9,1,11,8,3,16,32,55,0,Matches
248,Terence Kongolo,nl NED,DF,Huddersfield,24,1994,30.2,74,46,44,26,4,27,47,57.4,20,42,16,26,65,139,106,1,Matches
249,Laurent Koscielny,fr FRA,DF,Arsenal,32,1985,14.8,19,11,9,9,1,10,16,62.5,6,20,15,5,30,49,72,0,Matches
250,Cheikhou Kouyaté,sn SEN,MF,Crystal Palace,28,1989,21.1,59,33,23,31,5,9,33,27.3,24,29,11,18,16,75,33,0,Matches
251,Mateo Kovačić,hr CRO,MF,Chelsea,24,1994,19.3,45,29,23,19,3,20,46,43.5,26,19,2,17,8,53,18,1,Matches
252,Rajiv van La Parra,nl NED,"FW,MF",Huddersfield,27,1991,4.5,8,5,1,7,0,1,6,16.7,5,0,0,0,4,12,3,1,Matches
253,Alexandre Lacazette,fr FRA,FW,Arsenal,27,1991,27.8,35,16,6,19,10,5,28,17.9,23,27,1,26,15,50,31,0,Matches
254,Adam Lallana,eng ENG,"MF,FW",Liverpool,30,1988,5.2,16,9,6,7,3,5,12,41.7,7,10,1,9,5,21,4,0,Matches
255,Érik Lamela,ar ARG,"MF,FW",Tottenham,26,1992,10.8,17,13,6,7,4,5,14,35.7,9,14,0,14,7,24,1,0,Matches
256,Manuel Lanzini,ar ARG,MF,West Ham,25,1993,7.6,12,7,5,6,1,5,18,27.8,13,3,1,2,9,21,7,1,Matches
257,Aymeric Laporte,es ESP,DF,Manchester City,24,1994,34.0,42,20,27,14,1,22,34,64.7,12,16,9,7,39,81,98,2,Matches
258,Jamaal Lascelles,eng ENG,DF,Newcastle Utd,24,1993,30.5,32,21,25,5,2,11,14,78.6,3,43,28,15,39,71,218,3,Matches
259,Maxime Le Marchand,fr FRA,DF,Fulham,28,1989,25.0,56,36,45,11,0,23,47,48.9,24,30,16,14,54,110,129,2,Matches
260,Florian Lejeune,fr FRA,DF,Newcastle Utd,27,1991,11.7,25,15,17,7,1,11,24,45.8,13,16,5,11,21,46,49,0,Matches
261,Mario Lemina,ga GAB,MF,Southampton,24,1993,17.9,49,32,23,23,3,15,34,44.1,19,27,3,24,43,92,31,1,Matches
262,Aaron Lennon,eng ENG,MF,Burnley,31,1987,13.5,26,16,11,12,3,6,14,42.9,8,24,0,24,10,36,18,0,Matches
263,Bernd Leno,de GER,GK,Arsenal,26,1992,31.5,0,0,0,0,0,0,3,0.0,3,0,0,0,4,4,16,6,Matches
264,Jefferson Lerma,co COL,MF,Bournemouth,23,1994,27.8,45,31,20,20,5,14,54,25.9,40,35,19,16,54,99,88,1,Matches
265,Stephan Lichtsteiner,ch SUI,DF,Arsenal,34,1984,10.4,15,9,5,4,6,9,16,56.3,7,11,4,7,9,24,25,1,Matches
266,Victor Lindelöf,se SWE,DF,Manchester Utd,24,1994,28.9,40,27,28,12,0,13,23,56.5,10,21,12,9,24,64,121,3,Matches
267,Jesse Lingard,eng ENG,"FW,MF",Manchester Utd,25,1992,18.5,29,18,8,11,10,7,28,25.0,21,18,2,16,10,39,9,1,Matches
268,Fernando Llorente,es ESP,FW,Tottenham,33,1985,7.7,4,2,3,0,1,2,3,66.7,1,7,2,5,1,5,10,0,Matches
269,Hugo Lloris,fr FRA,GK,Tottenham,31,1986,33.0,1,0,1,0,0,0,2,0.0,2,0,0,0,0,1,13,5,Matches
270,Jürgen Locadia,cw CUW,"FW,MF",Brighton,24,1993,13.7,15,10,5,8,2,3,7,42.9,4,8,0,8,9,24,13,0,Matches
271,Ruben Loftus-Cheek,eng ENG,"MF,FW",Chelsea,22,1996,11.1,18,12,7,7,4,3,12,25.0,9,10,4,6,11,29,5,0,Matches
272,Kevin Long,ie IRL,DF,Burnley,27,1990,5.7,18,10,13,5,0,7,17,41.2,10,7,5,2,7,25,35,1,Matches
273,Shane Long,ie IRL,"FW,MF",Southampton,31,1987,14.1,15,8,4,5,6,3,16,18.8,13,10,1,9,7,22,18,0,Matches
274,Sean Longstaff,eng ENG,MF,Newcastle Utd,20,1997,7.6,17,13,6,11,0,9,24,37.5,15,19,4,15,10,27,7,0,Matches
275,Ademola Lookman,ng NGA,"FW,MF",Everton,20,1997,6.9,15,7,7,5,3,4,6,66.7,2,10,0,10,7,22,2,0,Matches
276,Jonas Lössl,dk DEN,GK,Huddersfield,29,1989,30.9,0,0,0,0,0,0,1,0.0,1,1,0,1,2,2,12,2,Matches
277,Dejan Lovren,hr CRO,DF,Liverpool,29,1989,11.0,15,9,10,5,0,7,15,46.7,8,11,7,4,11,26,51,2,Matches
278,Chris Löwe,de GER,"DF,MF",Huddersfield,29,1989,22.9,34,18,17,15,2,12,33,36.4,21,21,3,18,23,57,56,0,Matches
279,Matthew Lowton,eng ENG,DF,Burnley,29,1989,19.4,56,35,21,31,4,32,60,53.3,28,29,7,22,30,86,80,1,Matches
280,David Luiz,br BRA,DF,Chelsea,31,1987,36.0,41,31,27,13,1,21,28,75.0,7,33,18,15,35,76,149,1,Matches
281,Romelu Lukaku,be BEL,FW,Manchester Utd,25,1993,23.7,8,4,0,6,2,2,10,20.0,8,12,1,11,2,10,19,0,Matches
282,James Maddison,eng ENG,"MF,FW",Leicester City,21,1996,31.5,48,32,20,25,3,14,58,24.1,44,20,4,16,12,60,10,1,Matches
283,Gary Madine,eng ENG,"FW,MF",Cardiff City,27,1990,0.4,1,1,0,1,0,0,0,,0,0,0,0,0,1,0,0,Matches
284,Harry Maguire,eng ENG,DF,Leicester City,25,1993,28.8,31,17,21,9,1,11,17,64.7,6,32,18,14,36,67,155,4,Matches
285,Riyad Mahrez,dz ALG,"FW,MF",Manchester City,27,1991,14.9,14,7,3,7,4,6,18,33.3,12,18,1,17,9,23,3,1,Matches
286,Ainsley Maitland-Niles,eng ENG,DF,Arsenal,20,1997,11.0,33,22,19,12,2,14,28,50.0,14,22,4,18,19,52,15,2,Matches
287,Sadio Mané,sn SEN,FW,Liverpool,26,1992,34.2,35,29,12,17,6,14,43,32.6,29,28,4,24,15,50,10,1,Matches
288,Javier Manquillo,es ESP,DF,Newcastle Utd,24,1994,12.2,27,19,14,11,2,9,14,64.3,5,9,1,8,17,44,58,0,Matches
289,Solly March,eng ENG,"FW,MF",Brighton,24,1994,27.4,56,24,27,16,13,19,45,42.2,26,34,4,30,27,83,44,0,Matches
290,Adrian Mariappa,jm JAM,DF,Watford,31,1986,21.4,35,22,29,6,0,16,32,50.0,16,23,15,8,26,61,120,2,Matches
291,Lazar Marković,rs SRB,MF,Fulham,24,1994,0.5,0,0,0,0,0,0,0,,0,0,0,0,0,0,2,0,Matches
292,Anthony Martial,fr FRA,FW,Manchester Utd,22,1995,18.0,9,7,2,5,2,1,11,9.1,10,12,0,12,3,12,8,0,Matches
293,Adam Masina,ma MAR,DF,Watford,24,1994,11.2,30,17,16,13,1,13,25,52.0,12,19,4,15,17,47,40,0,Matches
294,Arthur Masuaku,cd COD,DF,West Ham,24,1993,19.5,57,25,38,13,6,31,56,55.4,25,27,6,21,36,93,72,0,Matches
295,Juan Mata,es ESP,"FW,MF",Manchester Utd,30,1988,14.3,9,4,7,1,1,6,21,28.6,15,8,1,7,6,15,6,0,Matches
296,Nemanja Matić,rs SRB,MF,Manchester Utd,29,1988,27.1,50,30,27,19,4,30,59,50.8,29,39,18,21,31,81,53,4,Matches
297,Joël Matip,cm CMR,DF,Liverpool,26,1991,17.1,39,26,23,12,4,13,24,54.2,11,12,7,5,32,71,78,0,Matches
298,Konstantinos Mavropanos,gr GRE,DF,Arsenal,20,1997,1.6,1,0,0,1,0,1,1,100.0,0,1,1,0,7,8,5,0,Matches
299,Alfie Mawson,eng ENG,DF,Fulham,24,1994,12.6,11,7,7,4,0,6,10,60.0,4,20,17,3,19,30,64,1,Matches
300,Isaac Mbenza,be BEL,"FW,MF",Huddersfield,22,1996,11.0,10,9,5,5,0,2,4,50.0,2,4,0,4,5,15,4,0,Matches
301,James McArthur,sct SCO,MF,Crystal Palace,30,1987,34.0,84,51,38,32,14,30,78,38.5,48,64,22,42,39,123,55,0,Matches
302,Alex McCarthy,eng ENG,GK,Southampton,28,1989,25.0,0,0,0,0,0,0,0,,0,0,0,0,0,0,6,2,Matches
303,James McCarthy,ie IRL,MF,Everton,27,1990,0.2,2,1,1,1,0,0,0,,0,0,0,0,1,3,0,0,Matches
304,Kevin McDonald,sct SCO,MF,Fulham,29,1988,9.3,15,11,6,8,1,5,13,38.5,8,8,2,6,9,24,22,0,Matches
305,Dwight McNeil,eng ENG,MF,Burnley,18,1999,17.7,36,22,16,17,3,13,44,29.5,31,30,3,27,13,49,35,0,Matches
306,Scott McTominay,sct SCO,"MF,DF",Manchester Utd,21,1996,9.6,10,9,3,6,1,4,10,40.0,6,9,4,5,15,25,16,0,Matches
307,Ben Mee,eng ENG,DF,Burnley,28,1989,38.0,55,24,38,17,0,35,44,79.5,9,59,50,9,48,103,235,4,Matches
308,Nathaniel Mendez-Laing,gt GUA,"MF,FW",Cardiff City,26,1992,10.9,34,25,18,12,4,12,26,46.2,14,17,1,16,13,47,20,0,Matches
309,Benjamin Mendy,fr FRA,DF,Manchester City,24,1994,10.0,16,10,10,5,1,9,17,52.9,8,13,4,9,10,26,18,0,Matches
310,Nampalys Mendy,sn SEN,MF,Leicester City,26,1992,23.2,33,18,16,16,1,6,22,27.3,16,24,8,16,26,59,26,2,Matches
311,Chris Mepham,wls WAL,DF,Bournemouth,20,1997,9.4,9,3,9,0,0,7,11,63.6,4,12,5,7,14,23,57,2,Matches
312,Max Meyer,de GER,MF,Crystal Palace,22,1995,15.7,33,18,14,18,1,11,20,55.0,9,6,0,6,15,48,19,0,Matches
313,Luka Milivojević,rs SRB,MF,Crystal Palace,27,1991,38.0,90,69,36,47,7,39,91,42.9,52,47,15,32,72,162,68,3,Matches
314,James Milner,eng ENG,"MF,DF",Liverpool,32,1986,19.9,43,23,14,24,5,15,41,36.6,26,40,5,35,18,61,30,0,Matches
315,Yerry Mina,co COL,DF,Everton,23,1994,9.9,14,7,8,6,0,6,9,66.7,3,11,5,6,8,22,54,3,Matches
316,Tyrone Mings,eng ENG,DF,Bournemouth,25,1993,1.6,4,3,3,1,0,2,3,66.7,1,5,2,3,6,10,8,0,Matches
317,Aleksandar Mitrović,rs SRB,FW,Fulham,23,1994,36.4,19,9,3,13,3,5,15,33.3,10,22,8,14,6,25,53,0,Matches
318,Henrikh Mkhitaryan,am ARM,"FW,MF",Arsenal,29,1989,18.2,28,22,8,17,3,6,22,27.3,16,34,2,32,16,44,13,0,Matches
319,Nacho Monreal,es ESP,DF,Arsenal,32,1986,20.7,35,17,21,9,5,15,25,60.0,10,28,10,18,31,66,62,0,Matches
320,Martín Montoya,es ESP,DF,Brighton,27,1991,24.1,58,35,29,21,8,32,55,58.2,23,30,10,20,48,106,76,1,Matches
321,Aaron Mooy,au AUS,"MF,FW",Huddersfield,27,1990,25.9,62,42,19,27,16,21,52,40.4,31,43,7,36,14,76,22,0,Matches
322,Álvaro Morata,es ESP,FW,Chelsea,25,1992,10.5,8,5,0,5,3,1,7,14.3,6,6,1,5,0,8,6,0,Matches
323,Alberto Moreno,es ESP,DF,Liverpool,26,1992,1.7,3,2,1,2,0,1,3,33.3,2,1,0,1,2,5,0,0,Matches
324,Wes Morgan,jm JAM,DF,Leicester City,34,1984,21.4,27,15,14,12,1,6,7,85.7,1,24,10,14,32,59,109,1,Matches
325,Sean Morrison,eng ENG,DF,Cardiff City,27,1991,33.8,35,17,29,4,2,15,28,53.6,13,47,30,17,52,87,204,5,Matches
326,Victor Moses,ng NGA,FW,Chelsea,27,1990,0.3,0,0,0,0,0,0,0,,0,1,0,1,0,0,0,0,Matches
327,Steve Mounié,bj BEN,FW,Huddersfield,23,1994,19.8,9,6,3,4,2,2,12,16.7,10,10,1,9,5,14,15,0,Matches
328,Lucas Moura,br BRA,"FW,MF",Tottenham,25,1992,23.6,35,18,8,20,7,9,27,33.3,18,15,1,14,24,59,24,0,Matches
329,Lys Mousset,fr FRA,FW,Bournemouth,22,1996,4.1,3,1,1,1,1,1,4,25.0,3,3,0,3,1,4,3,0,Matches
330,João Moutinho,pt POR,MF,Wolves,31,1986,33.7,113,58,50,56,7,44,126,34.9,82,56,11,45,40,153,50,0,Matches
331,Jacob Murphy,eng ENG,"MF,DF",Newcastle Utd,23,1995,3.4,6,2,4,2,0,2,4,50.0,2,5,2,3,1,7,7,0,Matches
332,Josh Murphy,eng ENG,"MF,FW",Cardiff City,23,1995,20.2,26,17,15,7,4,9,29,31.0,20,30,0,30,11,37,17,0,Matches
333,Glenn Murray,eng ENG,FW,Brighton,34,1983,27.9,17,7,4,7,6,4,20,20.0,16,20,3,17,2,19,17,1,Matches
334,Shkodran Mustafi,de GER,DF,Arsenal,26,1992,29.0,62,45,42,17,3,31,40,77.5,9,34,17,17,58,120,168,1,Matches
335,Yoshinori Mutō,jp JPN,"FW,MF",Newcastle Utd,26,1992,5.8,8,4,3,5,0,2,7,28.6,5,9,0,9,5,13,3,1,Matches
336,Georges-Kévin N'Koudou,cm CMR,FW,Tottenham,23,1995,0.1,0,0,0,0,0,0,0,,0,0,0,0,0,0,0,0,Matches
337,Samir Nasri,fr FRA,MF,West Ham,31,1987,2.7,0,0,0,0,0,0,0,,0,1,0,1,1,1,1,0,Matches
338,Marc Navarro,es ESP,DF,Watford,23,1995,0.9,4,2,3,1,0,3,4,75.0,1,0,0,0,0,4,4,0,Matches
339,Wilfred Ndidi,ng NGA,MF,Leicester City,21,1996,36.6,142,98,66,67,9,46,95,48.4,49,64,9,55,83,225,85,2,Matches
340,Rúben Neves,pt POR,MF,Wolves,21,1997,33.4,75,32,33,36,6,27,83,32.5,56,57,18,39,73,148,46,3,Matches
341,Oumar Niasse,sn SEN,FW,Cardiff City,28,1990,10.3,12,3,1,5,6,4,8,50.0,4,7,0,7,2,14,7,0,Matches
342,Oumar Niasse,sn SEN,FW,Everton,28,1990,0.7,0,0,0,0,0,0,1,0.0,1,0,0,0,0,0,0,0,Matches
343,Eddie Nketiah,eng ENG,"MF,FW",Arsenal,19,1999,0.7,1,1,0,1,0,0,0,,0,0,0,0,0,1,1,0,Matches
344,Mark Noble,eng ENG,MF,West Ham,31,1987,25.5,47,26,19,24,4,17,52,32.7,35,17,2,15,21,68,13,0,Matches
345,Håvard Nordtveit,no NOR,DF,Fulham,28,1990,4.0,9,4,8,1,0,4,5,80.0,1,3,3,0,8,17,15,1,Matches
346,Will Norris,eng ENG,GK,Wolves,24,1993,0.0,0,0,0,0,0,0,0,,0,0,0,0,0,0,0,0,Matches
347,Michael Obafemi,ie IRL,FW,Southampton,18,2000,1.5,1,1,0,0,1,0,0,,0,1,1,0,1,2,0,0,Matches
348,Pedro Obiang,gq EQG,MF,West Ham,26,1992,12.5,41,23,23,16,2,18,43,41.9,25,27,9,18,12,53,18,0,Matches
349,Denis Odoi,gh GHA,DF,Fulham,30,1988,28.8,48,34,29,16,3,21,33,63.6,12,45,24,21,42,90,153,0,Matches
350,Angelo Ogbonna,it ITA,DF,West Ham,30,1988,20.8,31,13,23,6,2,14,23,60.9,9,29,19,10,35,66,101,0,Matches
351,Stefano Okaka,it ITA,"FW,MF",Watford,28,1989,0.3,0,0,0,0,0,0,0,,0,1,0,1,0,0,0,0,Matches
352,Shinji Okazaki,jp JPN,"MF,FW",Leicester City,32,1986,3.2,5,5,2,3,0,0,1,0.0,1,7,1,6,2,7,1,0,Matches
353,Divock Origi,be BEL,FW,Liverpool,23,1995,4.1,6,1,2,3,1,1,4,25.0,3,2,0,2,0,6,2,0,Matches
354,Nicolás Otamendi,ar ARG,DF,Manchester City,30,1988,13.7,24,14,17,6,1,5,9,55.6,4,6,4,2,29,53,56,1,Matches
355,Alex Oxlade-Chamberlain,eng ENG,MF,Liverpool,24,1993,0.2,1,1,0,1,0,1,1,100.0,0,0,0,0,1,2,0,0,Matches
356,Mesut Özil,de GER,"MF,FW",Arsenal,29,1988,19.3,12,5,6,3,3,3,21,14.3,18,10,2,8,4,16,5,0,Matches
357,Emerson Palmieri,it ITA,DF,Chelsea,23,1994,7.4,14,9,6,5,3,6,10,60.0,4,11,1,10,8,22,14,0,Matches
358,Sokratis Papastathopoulos,gr GRE,DF,Arsenal,30,1988,24.4,42,25,30,11,1,15,28,53.6,13,34,17,17,26,68,112,1,Matches
359,Callum Paterson,sct SCO,"FW,MF",Cardiff City,23,1994,22.2,21,14,7,7,7,5,26,19.2,21,23,2,21,8,29,29,0,Matches
360,Rui Patrício,pt POR,GK,Wolves,30,1988,37.0,2,0,2,0,0,2,3,66.7,1,0,0,0,1,3,7,4,Matches
361,Pedro,es ESP,FW,Chelsea,31,1987,19.8,27,14,11,10,6,9,35,25.7,26,13,2,11,18,45,8,1,Matches
362,Lee Peltier,eng ENG,DF,Cardiff City,31,1986,17.2,39,25,27,11,1,15,27,55.6,12,18,12,6,18,57,60,0,Matches
363,Andreas Pereira,br BRA,MF,Manchester Utd,22,1996,6.7,8,6,5,2,1,4,15,26.7,11,9,2,7,11,19,8,1,Matches
364,Ricardo Pereira,pt POR,"DF,FW",Leicester City,24,1993,34.7,118,66,66,40,12,54,112,48.2,58,60,6,54,60,178,130,1,Matches
365,Roberto Pereyra,ar ARG,MF,Watford,27,1991,31.3,21,12,10,10,1,7,24,29.2,17,26,0,26,24,45,27,2,Matches
366,Ayoze Pérez,es ESP,"MF,FW",Newcastle Utd,25,1993,32.4,59,22,24,28,7,17,63,27.0,46,55,4,51,42,101,33,1,Matches
367,Lucas Pérez,es ESP,"FW,MF",West Ham,29,1988,5.3,6,4,3,2,1,1,3,33.3,2,2,1,1,2,8,2,0,Matches
368,Jordan Pickford,eng ENG,GK,Everton,24,1994,38.0,0,0,0,0,0,0,0,,0,0,0,0,0,0,20,8,Matches
369,Paul Pogba,fr FRA,MF,Manchester Utd,25,1993,33.4,47,30,21,21,5,17,43,39.5,26,30,9,21,18,65,39,0,Matches
370,Alex Pritchard,eng ENG,"MF,FW",Huddersfield,25,1993,23.1,36,24,10,18,8,10,35,28.6,25,26,2,24,17,53,9,0,Matches
371,Sebastian Prödl,at AUT,DF,Watford,31,1987,0.1,0,0,0,0,0,0,0,,0,0,0,0,0,0,0,0,Matches
372,Davy Pröpper,nl NED,MF,Brighton,26,1991,28.3,50,28,23,21,6,16,52,30.8,36,21,6,15,53,103,37,0,Matches
373,Jason Puncheon,eng ENG,MF,Crystal Palace,32,1986,0.1,1,1,1,0,0,0,0,,0,0,0,0,0,1,0,0,Matches
374,Jason Puncheon,eng ENG,MF,Huddersfield,32,1986,4.2,7,4,1,5,1,1,7,14.3,6,3,1,2,3,10,8,0,Matches
375,Collin Quaner,de GER,FW,Huddersfield,27,1991,0.4,0,0,0,0,0,0,1,0.0,1,0,0,0,0,0,0,0,Matches
376,Domingos Quina,pt POR,MF,Watford,18,1999,3.8,9,7,3,5,1,3,11,27.3,8,6,0,6,3,12,1,0,Matches
377,Joe Ralls,eng ENG,MF,Cardiff City,24,1993,21.8,45,23,21,21,3,10,33,30.3,23,21,6,15,29,74,30,0,Matches
378,Aaron Ramsey,wls WAL,MF,Arsenal,27,1990,14.8,34,18,11,15,8,7,25,28.0,18,7,1,6,9,43,3,0,Matches
379,Kayne Ramsey,eng ENG,DF,Southampton,17,2000,1.0,0,0,0,0,0,0,0,,0,0,0,0,0,0,7,0,Matches
380,Marcus Rashford,eng ENG,FW,Manchester Utd,20,1997,25.9,24,12,4,12,8,7,29,24.1,22,27,0,27,3,27,24,0,Matches
381,Tim Ream,us USA,DF,Fulham,30,1987,22.7,23,14,16,7,0,14,28,50.0,14,19,10,9,25,48,80,2,Matches
382,Nathan Redmond,eng ENG,"MF,FW",Southampton,24,1994,36.3,45,22,14,19,12,14,41,34.1,27,54,2,52,20,65,23,1,Matches
383,Bobby Reid,jm JAM,"FW,MF",Cardiff City,25,1993,15.8,16,9,6,7,3,3,8,37.5,5,13,0,13,3,19,12,0,Matches
384,Declan Rice,eng ENG,MF,West Ham,19,1999,33.4,98,60,35,58,5,38,88,43.2,50,51,12,39,52,150,56,0,Matches
385,Jazz Richards,wls WAL,"DF,MF",Cardiff City,27,1991,1.5,0,0,0,0,0,0,1,0.0,1,2,1,1,2,2,5,0,Matches
386,Richarlison,br BRA,"FW,MF",Everton,21,1997,29.6,49,34,19,20,10,8,24,33.3,16,30,2,28,16,65,39,0,Matches
387,Diego Rico,es ESP,"DF,MF",Bournemouth,25,1993,6.8,14,9,8,2,4,4,12,33.3,8,13,2,11,14,28,20,0,Matches
388,Sergio Rico,es ESP,GK,Fulham,24,1993,29.0,1,1,1,0,0,1,1,100.0,0,0,0,0,1,2,13,5,Matches
389,Matt Ritchie,sct SCO,"DF,MF",Newcastle Utd,28,1989,32.5,70,44,35,27,8,19,47,40.4,28,34,11,23,51,121,76,1,Matches
390,Andrew Robertson,sct SCO,DF,Liverpool,24,1994,35.7,80,49,41,31,8,39,70,55.7,31,33,6,27,29,109,57,3,Matches
391,Marcos Rojo,ar ARG,DF,Manchester Utd,28,1990,2.4,5,3,3,2,0,1,6,16.7,5,3,2,1,6,11,9,1,Matches
392,Oriol Romeu,es ESP,MF,Southampton,26,1991,23.7,81,46,39,38,4,32,77,41.6,45,43,17,26,52,133,44,1,Matches
393,Salomón Rondón,ve VEN,FW,Newcastle Utd,28,1989,28.9,8,3,2,4,2,4,24,16.7,20,14,3,11,5,13,39,0,Matches
394,Danny Rose,eng ENG,DF,Tottenham,28,1990,20.0,49,31,26,16,7,20,32,62.5,12,24,4,20,24,73,28,3,Matches
395,Aaron Rowe,eng ENG,FW,Huddersfield,17,2000,0.8,1,0,1,0,0,0,0,,0,0,0,0,1,2,1,0,Matches
396,John Ruddy,eng ENG,GK,Wolves,31,1986,1.0,0,0,0,0,0,0,0,,0,0,0,0,0,0,0,0,Matches
397,Antonio Rüdiger,de GER,DF,Chelsea,25,1993,31.9,34,16,27,6,1,15,27,55.6,12,15,8,7,32,66,96,1,Matches
398,Mathew Ryan,au AUS,GK,Brighton,26,1992,34.0,1,0,1,0,0,1,2,50.0,1,0,0,0,0,1,13,1,Matches
399,Abdelhamid Sabiri,ma MAR,FW,Huddersfield,21,1996,0.5,2,1,1,1,0,0,0,,0,1,0,1,1,3,0,0,Matches
400,Romain Saïss,ma MAR,"MF,DF",Wolves,28,1990,12.8,39,26,23,14,2,20,37,54.1,17,25,12,13,26,65,61,0,Matches
401,Bukayo Saka,eng ENG,FW,Arsenal,16,2001,0.1,0,0,0,0,0,0,0,,0,0,0,0,0,0,0,0,Matches
402,Mamadou Sakho,fr FRA,DF,Crystal Palace,28,1990,26.8,25,16,22,3,0,11,18,61.1,7,26,16,10,41,66,136,2,Matches
403,Bakary Sako,ml MLI,FW,Crystal Palace,30,1988,0.3,2,1,2,0,0,1,1,100.0,0,0,0,0,0,2,0,0,Matches
404,Mohamed Salah,eg EGY,FW,Liverpool,26,1992,36.1,21,9,3,11,7,5,16,31.3,11,9,0,9,5,26,6,0,Matches
405,Alexis Sánchez,cl CHI,"FW,MF",Manchester Utd,29,1988,9.8,17,10,5,9,3,5,13,38.5,8,7,0,7,9,26,2,0,Matches
406,Carlos Sánchez,co COL,MF,West Ham,32,1986,2.7,4,3,4,0,0,3,8,37.5,5,1,0,1,1,5,5,2,Matches
407,Davinson Sánchez,co COL,DF,Tottenham,22,1996,21.6,37,20,28,9,0,20,37,54.1,17,17,9,8,30,67,103,2,Matches
408,Leroy Sané,de GER,FW,Manchester City,22,1996,20.7,24,15,8,7,9,2,23,8.7,21,21,2,19,8,32,2,0,Matches
409,Fabian Schär,ch SUI,DF,Newcastle Utd,26,1991,22.2,60,39,37,19,4,24,50,48.0,26,40,16,24,67,127,145,2,Matches
410,Christopher Schindler,de GER,DF,Huddersfield,28,1990,36.2,61,36,46,14,1,27,47,57.4,20,69,34,35,70,131,138,4,Matches
411,Jeffrey Schlupp,gh GHA,"MF,FW",Crystal Palace,25,1992,18.6,41,20,18,18,5,10,27,37.0,17,30,8,22,19,60,27,1,Matches
412,Kasper Schmeichel,dk DEN,GK,Leicester City,31,1986,38.0,1,1,1,0,0,1,1,100.0,0,0,0,0,3,4,14,3,Matches
413,Morgan Schneiderlin,fr FRA,MF,Everton,28,1989,9.3,24,16,11,11,2,6,14,42.9,8,16,3,13,15,39,16,0,Matches
414,André Schürrle,de GER,"FW,MF",Fulham,27,1990,18.2,30,19,14,10,6,12,42,28.6,30,16,1,15,8,38,17,1,Matches
415,Ken Sema,se SWE,"MF,FW",Watford,24,1993,8.4,15,7,7,5,3,9,21,42.9,12,7,0,7,8,23,5,0,Matches
416,Jean Seri,ci CIV,MF,Fulham,27,1991,24.9,41,28,20,20,1,13,45,28.9,32,40,9,31,32,73,17,4,Matches
417,Ryan Sessegnon,eng ENG,"FW,DF",Fulham,18,2000,25.6,22,14,8,8,6,6,22,27.3,16,25,2,23,19,41,49,1,Matches
418,Xherdan Shaqiri,ch SUI,"FW,MF",Liverpool,26,1991,11.8,14,4,3,9,2,9,19,47.4,10,6,1,5,6,20,6,0,Matches
419,Luke Shaw,eng ENG,DF,Manchester Utd,23,1995,28.8,55,29,17,31,7,28,47,59.6,19,42,12,30,21,76,93,2,Matches
420,Jonjo Shelvey,eng ENG,MF,Newcastle Utd,26,1992,10.5,22,12,10,9,3,8,17,47.1,9,10,3,7,7,29,15,0,Matches
421,Gylfi Sigurðsson,is ISL,MF,Everton,28,1989,34.6,56,36,20,25,11,16,47,34.0,31,38,4,34,28,84,24,0,Matches
422,Adrien Silva,pt POR,MF,Leicester City,29,1989,1.0,2,2,0,1,1,0,2,0.0,2,1,0,1,1,3,1,0,Matches
423,Bernardo Silva,pt POR,"MF,FW",Manchester City,23,1994,31.7,52,39,18,21,13,16,67,23.9,51,47,3,44,25,77,26,1,Matches
424,David Silva,es ESP,MF,Manchester City,32,1986,26.7,30,18,12,11,7,1,20,5.0,19,18,1,17,22,52,15,0,Matches
425,Xande Silva,pt POR,FW,West Ham,21,1997,0.2,0,0,0,0,0,0,0,,0,1,0,1,0,0,0,0,Matches
426,Danny Simpson,eng ENG,DF,Leicester City,31,1987,3.2,11,3,8,3,0,3,5,60.0,2,7,3,4,6,17,20,0,Matches
427,Jack Simpson,eng ENG,DF,Bournemouth,21,1996,4.5,9,5,8,1,0,6,9,66.7,3,5,4,1,9,18,25,2,Matches
428,Josh Sims,eng ENG,MF,Southampton,21,1997,2.4,1,0,1,0,0,1,3,33.3,2,2,0,2,1,2,1,0,Matches
429,Moussa Sissoko,fr FRA,"MF,FW",Tottenham,28,1989,25.9,36,25,18,14,4,15,29,51.7,14,31,4,27,16,52,25,2,Matches
430,Oliver Skipp,eng ENG,MF,Tottenham,17,2000,2.4,7,3,4,3,0,4,6,66.7,2,2,1,1,1,8,7,0,Matches
431,Callum Slattery,eng ENG,MF,Southampton,19,1999,1.2,4,3,0,4,0,3,7,42.9,4,1,1,0,2,6,1,0,Matches
432,Chris Smalling,eng ENG,DF,Manchester Utd,28,1989,23.6,30,17,21,9,0,11,17,64.7,6,37,25,12,26,56,109,1,Matches
433,Adam Smith,eng ENG,"DF,MF",Bournemouth,27,1991,23.0,46,32,26,14,6,19,41,46.3,22,26,7,19,31,77,68,1,Matches
434,Tommy Smith,eng ENG,DF,Huddersfield,26,1992,12.7,26,13,14,11,1,10,25,40.0,15,12,4,8,18,44,25,0,Matches
435,Robert Snodgrass,sct SCO,MF,West Ham,30,1987,24.7,44,27,18,24,2,13,46,28.3,33,24,4,20,11,55,23,0,Matches
436,Cédric Soares,pt POR,DF,Southampton,26,1991,16.6,22,16,15,6,1,9,15,60.0,6,21,5,16,22,44,60,2,Matches
437,Ramadan Sobhi,eg EGY,"FW,MF",Huddersfield,21,1997,0.9,1,1,0,1,0,0,0,,0,2,0,2,1,2,0,0,Matches
438,Dominic Solanke,eng ENG,"FW,MF",Bournemouth,20,1997,3.9,8,3,1,4,3,1,8,12.5,7,4,1,3,2,10,9,0,Matches
439,Pape Souaré,sn SEN,DF,Crystal Palace,28,1990,0.0,0,0,0,0,0,0,0,,0,0,0,0,1,1,0,0,Matches
440,Çağlar Söyüncü,tr TUR,DF,Leicester City,22,1996,4.1,5,2,4,1,0,3,6,50.0,3,8,5,3,7,12,22,3,Matches
441,Julián Speroni,ar ARG,GK,Crystal Palace,39,1979,1.0,0,0,0,0,0,0,0,,0,0,0,0,0,0,1,2,Matches
442,Junior Stanislas,eng ENG,"MF,FW",Bournemouth,28,1989,11.5,12,6,5,4,3,3,7,42.9,4,8,1,7,2,14,15,0,Matches
443,Dale Stephens,eng ENG,MF,Brighton,29,1989,27.6,83,57,37,41,5,28,74,37.8,46,33,13,20,46,129,47,0,Matches
444,Jack Stephens,eng ENG,DF,Southampton,24,1994,18.9,25,13,17,7,1,16,28,57.1,12,25,13,12,37,62,96,2,Matches
445,Raheem Sterling,eng ENG,FW,Manchester City,23,1994,30.8,32,16,11,12,9,9,25,36.0,16,28,3,25,17,49,4,0,Matches
446,John Stones,eng ENG,DF,Manchester City,24,1994,19.6,16,11,9,5,2,4,9,44.4,5,15,9,6,14,30,64,1,Matches
447,Daniel Sturridge,eng ENG,"FW,MF",Liverpool,28,1989,5.7,3,3,1,1,1,2,3,66.7,1,4,0,4,1,4,0,0,Matches
448,Denis Suárez,es ESP,"MF,FW",Arsenal,24,1994,0.8,1,1,0,1,0,0,5,0.0,5,0,0,0,1,2,0,0,Matches
449,Isaac Success,ng NGA,"FW,MF",Watford,22,1996,11.7,15,12,4,8,3,2,5,40.0,3,6,0,6,2,17,11,0,Matches
450,Ki Sung-yueng,kr KOR,MF,Newcastle Utd,29,1989,14.5,14,10,5,8,1,3,12,25.0,9,11,1,10,19,33,20,0,Matches
451,Andrew Surman,eng ENG,MF,Bournemouth,31,1986,16.0,11,6,6,5,0,3,13,23.1,10,20,7,13,10,21,34,1,Matches
452,Sam Surridge,eng ENG,"MF,FW",Bournemouth,20,1998,0.1,1,0,0,0,1,0,0,,0,0,0,0,0,1,0,0,Matches
453,Alexander Sørloth,no NOR,FW,Crystal Palace,22,1995,2.1,2,1,0,0,2,1,2,50.0,1,0,0,0,0,2,3,0,Matches
454,Matt Targett,eng ENG,DF,Southampton,22,1995,13.2,27,19,15,7,5,12,26,46.2,14,19,3,16,27,54,42,0,Matches
455,James Tarkowski,eng ENG,DF,Burnley,25,1992,34.3,71,36,52,18,1,29,50,58.0,21,72,56,16,42,113,240,2,Matches
456,Charlie Taylor,eng ENG,DF,Burnley,24,1993,36.0,55,26,37,15,3,24,50,48.0,26,74,35,39,40,95,120,0,Matches
457,Youri Tielemans,be BEL,MF,Leicester City,21,1997,12.1,17,8,5,9,3,5,17,29.4,12,13,2,11,5,22,13,1,Matches
458,James Tomkins,eng ENG,DF,Crystal Palace,29,1989,28.4,34,20,27,7,0,15,28,53.6,13,23,10,13,34,68,184,3,Matches
459,Lucas Torreira,uy URU,MF,Arsenal,22,1996,26.5,65,39,24,32,9,25,57,43.9,32,34,7,27,41,106,33,2,Matches
460,Cenk Tosun,tr TUR,FW,Everton,27,1991,11.8,13,9,3,6,4,4,13,30.8,9,12,0,12,5,18,3,0,Matches
461,Andros Townsend,eng ENG,"FW,MF",Crystal Palace,27,1991,33.4,62,35,38,16,8,35,89,39.3,54,48,5,43,38,100,28,0,Matches
462,Adama Traoré,es ESP,"FW,MF",Wolves,22,1996,10.0,16,13,11,3,2,4,9,44.4,5,11,0,11,6,22,7,0,Matches
463,Mark Travers,ie IRL,GK,Bournemouth,19,1999,2.0,0,0,0,0,0,0,0,,0,0,0,0,0,0,2,0,Matches
464,Kieran Trippier,eng ENG,DF,Tottenham,27,1990,25.3,67,37,43,16,8,37,62,59.7,25,38,5,33,23,90,77,2,Matches
465,Antonio Valencia,ec ECU,DF,Manchester Utd,32,1985,5.2,8,6,2,4,2,3,4,75.0,1,9,0,9,5,13,10,0,Matches
466,Yan Valery,tn TUN,DF,Southampton,19,1999,19.0,42,36,26,10,6,16,29,55.2,13,24,3,21,22,64,72,1,Matches
467,Virgil van Dijk,nl NED,DF,Liverpool,27,1991,37.6,38,28,26,11,1,14,14,100.0,0,29,18,11,40,78,201,1,Matches
468,Jamie Vardy,eng ENG,FW,Leicester City,31,1987,30.3,14,8,3,6,5,4,17,23.5,13,16,1,15,6,20,28,0,Matches
469,Jan Vertonghen,be BEL,DF,Tottenham,31,1987,21.2,39,24,17,20,2,14,24,58.3,10,18,11,7,32,71,81,0,Matches
470,Jannik Vestergaard,dk DEN,DF,Southampton,25,1992,22.5,53,33,37,13,3,28,45,62.2,17,35,20,15,35,88,174,1,Matches
471,Luciano Vietto,ar ARG,"FW,MF",Fulham,24,1993,11.0,15,11,5,5,5,4,19,21.1,15,9,0,9,6,21,5,0,Matches
472,Rúben Vinagre,pt POR,"DF,MF",Wolves,19,1999,7.9,14,9,7,7,0,2,5,40.0,3,10,2,8,14,28,16,1,Matches
473,Sam Vokes,wls WAL,FW,Burnley,28,1989,10.2,4,2,1,2,1,0,0,,0,2,1,1,0,4,17,0,Matches
474,Michel Vorm,nl NED,GK,Tottenham,34,1983,2.0,0,0,0,0,0,0,0,,0,0,0,0,0,0,1,0,Matches
475,Matěj Vydra,cz CZE,FW,Burnley,26,1992,3.5,2,1,0,1,1,0,3,0.0,3,4,1,3,1,3,6,0,Matches
476,Theo Walcott,eng ENG,"FW,MF",Everton,29,1989,23.5,27,17,11,9,7,10,22,45.5,12,17,1,16,22,49,8,0,Matches
477,Kyle Walker,eng ENG,DF,Manchester City,28,1990,30.9,40,26,20,20,0,24,38,63.2,14,19,5,14,36,76,58,2,Matches
478,Kyle Walker-Peters,eng ENG,DF,Tottenham,21,1997,4.2,7,4,4,2,1,3,4,75.0,1,5,1,4,4,11,6,0,Matches
479,Aaron Wan-Bissaka,eng ENG,DF,Crystal Palace,20,1997,34.8,129,90,90,33,6,55,65,84.6,10,49,16,33,84,213,161,0,Matches
480,Victor Wanyama,ke KEN,MF,Tottenham,27,1991,5.7,13,13,8,5,0,6,12,50.0,6,9,3,6,7,20,11,0,Matches
481,Danny Ward,eng ENG,FW,Cardiff City,26,1991,4.9,2,1,0,1,1,0,3,0.0,3,3,1,2,0,2,9,0,Matches
482,Joel Ward,eng ENG,DF,Crystal Palace,28,1989,6.1,12,7,7,4,1,3,10,30.0,7,2,0,2,10,22,35,0,Matches
483,Stephen Ward,ie IRL,DF,Burnley,32,1985,2.5,4,2,1,2,1,1,4,25.0,3,3,1,2,4,8,14,0,Matches
484,James Ward-Prowse,eng ENG,"MF,DF",Southampton,23,1994,21.6,36,17,19,13,4,14,43,32.6,29,30,6,24,27,63,59,0,Matches
485,Danny Welbeck,eng ENG,"FW,MF",Arsenal,27,1990,1.7,3,2,0,2,1,0,0,,0,2,0,2,1,4,2,0,Matches
486,Ashley Westwood,eng ENG,MF,Burnley,28,1990,31.4,58,30,24,27,7,14,39,35.9,25,38,9,29,47,105,42,2,Matches
487,Connor Wickham,eng ENG,"FW,MF",Crystal Palace,25,1993,0.7,0,0,0,0,0,0,0,,0,0,0,0,0,0,2,0,Matches
488,Georginio Wijnaldum,nl NED,MF,Liverpool,27,1990,30.3,41,28,14,20,7,14,27,51.9,13,21,7,14,21,62,24,0,Matches
489,Danny Williams,us USA,MF,Huddersfield,29,1989,1.1,0,0,0,0,0,0,0,,0,4,1,3,1,1,2,0,Matches
490,Willian,br BRA,FW,Chelsea,29,1988,23.3,35,21,11,15,9,9,25,36.0,16,16,1,15,14,49,12,2,Matches
491,Joe Willock,eng ENG,"MF,FW",Arsenal,18,1999,0.7,1,0,0,1,0,0,0,,0,1,0,1,1,2,0,0,Matches
492,Ben Wilmot,eng ENG,"MF,DF",Watford,18,1999,0.3,0,0,0,0,0,0,1,0.0,1,2,1,1,0,0,1,0,Matches
493,Jack Wilshere,eng ENG,MF,West Ham,26,1992,4.4,7,4,1,4,2,2,6,33.3,4,3,1,2,7,14,0,0,Matches
494,Callum Wilson,eng ENG,FW,Bournemouth,26,1992,28.1,9,7,4,3,2,0,8,0.0,8,14,4,10,4,13,16,0,Matches
495,Harry Winks,eng ENG,MF,Tottenham,22,1996,17.7,22,13,12,9,1,5,30,16.7,25,19,3,16,21,43,19,0,Matches
496,Chris Wood,nz NZL,FW,Burnley,26,1991,28.8,12,8,0,7,5,5,17,29.4,12,17,4,13,3,15,26,0,Matches
497,Granit Xhaka,ch SUI,"MF,DF",Arsenal,25,1992,27.8,52,29,29,20,3,24,59,40.7,35,35,9,26,36,88,56,3,Matches
498,Andriy Yarmolenko,ua UKR,"MF,FW",West Ham,28,1989,5.1,4,1,2,1,1,4,6,66.7,2,4,1,3,2,6,4,2,Matches
499,DeAndre Yedlin,us USA,DF,Newcastle Utd,25,1993,27.5,54,32,36,14,4,19,41,46.3,22,36,10,26,28,82,88,0,Matches
500,Maya Yoshida,jp JPN,DF,Southampton,29,1988,16.9,16,12,5,10,1,4,13,30.8,9,24,20,4,42,58,103,1,Matches
501,Ashley Young,eng ENG,DF,Manchester Utd,33,1985,28.5,52,32,34,16,2,20,39,51.3,19,36,10,26,55,107,74,0,Matches
502,Pablo Zabaleta,ar ARG,DF,West Ham,33,1985,23.2,47,24,26,15,6,17,44,38.6,27,39,15,24,48,95,96,3,Matches
503,Wilfried Zaha,ci CIV,FW,Crystal Palace,25,1992,33.7,39,20,11,23,5,12,34,35.3,22,19,0,19,10,49,4,0,Matches
504,Andre-Frank Zambo Anguissa,cm CMR,MF,Fulham,22,1995,16.9,48,29,23,20,5,18,52,34.6,34,25,6,19,34,82,32,0,Matches
505,Davide Zappacosta,it ITA,DF,Chelsea,26,1992,1.4,0,0,0,0,0,0,1,0.0,1,0,0,0,3,3,5,0,Matches
506,Oleksandr Zinchenko,ua UKR,DF,Manchester City,21,1996,12.8,34,20,13,15,6,14,33,42.4,19,14,3,11,20,54,19,1,Matches
507,Kenneth Zohore,dk DEN,FW,Cardiff City,24,1994,8.4,3,2,0,3,0,1,3,33.3,2,4,2,2,2,5,5,0,Matches
508,Kurt Zouma,fr FRA,DF,Everton,23,1994,29.0,32,21,16,14,2,4,11,36.4,7,27,12,15,54,86,126,2,Matches
1,Brenden Aaronson,us USA,"MF,FW",Leeds United,21,2000,26.4,45,18,16,22,7,15,46,32.6,31,43,3,40,5,50,6,1,Matches
2,George Abbott,eng ENG,MF,Tottenham,16,2005,0.0,0,0,0,0,0,0,0,,0,0,0,0,1,1,0,0,Matches
3,Che Adams,sct SCO,FW,Southampton,26,1996,22.1,17,13,7,8,2,7,12,58.3,5,13,4,9,4,21,22,0,Matches
4,Tyler Adams,us USA,MF,Leeds United,23,1999,24.0,89,46,44,35,10,50,77,64.9,27,48,8,40,35,124,29,0,Matches
5,Tosin Adarabioyo,eng ENG,DF,Fulham,24,1997,23.2,30,13,22,6,2,16,23,69.6,7,20,15,5,26,56,140,1,Matches
6,Nayef Aguerd,ma MAR,DF,West Ham,26,1996,17.7,27,18,18,8,1,13,20,65.0,7,26,24,2,18,45,79,2,Matches
7,Naouirou Ahamada,fr FRA,"MF,FW",Crystal Palace,20,2002,1.0,3,2,3,0,0,1,3,33.3,2,2,0,2,0,3,0,0,Matches
8,Rayan Aït-Nouri,dz ALG,DF,Wolves,21,2001,12.0,33,20,25,7,1,9,16,56.3,7,3,0,3,9,42,28,0,Matches
9,Kristoffer Ajer,no NOR,DF,Brentford,24,1998,8.5,11,8,5,4,2,9,16,56.3,7,6,5,1,7,18,22,0,Matches
10,Manuel Akanji,ch SUI,DF,Manchester City,27,1995,25.4,36,25,15,18,3,23,36,63.9,13,27,9,18,16,52,33,1,Matches
11,Nathan Aké,nl NED,DF,Manchester City,27,1995,20.8,26,12,15,9,2,11,15,73.3,4,20,10,10,20,46,48,0,Matches
12,Marc Albrighton,eng ENG,"FW,MF",Leicester City,32,1989,2.6,4,1,0,2,2,1,8,12.5,7,6,2,4,1,5,5,0,Matches
13,Thiago Alcántara,es ESP,MF,Liverpool,31,1991,13.9,43,24,20,21,2,14,23,60.9,9,15,3,12,21,64,13,2,Matches
14,Carlos Alcaraz,ar ARG,"MF,FW",Southampton,19,2002,11.4,10,5,2,7,1,6,22,27.3,16,14,5,9,1,11,11,0,Matches
15,Trent Alexander-Arnold,eng ENG,DF,Liverpool,23,1998,32.5,57,40,32,16,9,42,80,52.5,38,25,7,18,43,100,41,2,Matches
16,Alisson,br BRA,GK,Liverpool,29,1992,37.0,0,0,0,0,0,0,3,0.0,3,3,0,3,0,0,20,0,Matches
17,Dele Alli,eng ENG,MF,Everton,26,1996,0.4,0,0,0,0,0,0,0,,0,0,0,0,0,0,0,0,Matches
18,Miguel Almirón,py PAR,FW,Newcastle Utd,28,1994,27.7,46,30,16,19,11,18,42,42.9,24,25,2,23,10,56,17,0,Matches
19,Julián Álvarez,ar ARG,"FW,MF",Manchester City,22,2000,16.3,26,16,3,13,10,9,30,30.0,21,13,0,13,2,28,6,0,Matches
20,Daniel Amartey,gh GHA,DF,Leicester City,27,1994,17.9,19,8,13,5,1,12,14,85.7,2,24,17,7,8,27,71,0,Matches
21,Samuel Amo-Ameyaw,eng ENG,MF,Southampton,16,2006,0.0,0,0,0,0,0,0,1,0.0,1,0,0,0,0,0,0,0,Matches
22,Joachim Andersen,dk DEN,DF,Crystal Palace,26,1996,30.9,42,22,30,12,0,16,32,50.0,16,28,13,15,24,66,188,1,Matches
23,Elliot Anderson,eng ENG,"MF,FW",Newcastle Utd,19,2002,4.6,11,5,5,3,3,6,12,50.0,6,11,2,9,6,17,2,0,Matches
24,Jaidon Anthony,eng ENG,"MF,FW",Bournemouth,22,1999,14.0,30,17,15,9,6,8,24,33.3,16,30,3,27,10,40,19,0,Matches
25,Michail Antonio,jm JAM,FW,West Ham,32,1990,20.3,14,7,1,8,5,3,12,25.0,9,13,5,8,5,19,9,0,Matches
26,Antony,br BRA,FW,Manchester Utd,22,2000,20.0,22,9,9,9,4,8,28,28.6,20,18,0,18,11,33,6,0,Matches
27,Cameron Archer,eng ENG,"FW,MF",Aston Villa,21,2001,0.5,0,0,0,0,0,0,0,,0,0,0,0,0,0,0,0,Matches
28,Alphonse Areola,fr FRA,GK,West Ham,29,1993,3.4,0,0,0,0,0,0,0,,0,0,0,0,0,0,0,0,Matches
29,Joe Aribo,ng NGA,"MF,FW",Southampton,26,1996,13.6,31,20,15,12,4,11,20,55.0,9,14,1,13,10,41,11,0,Matches
30,Adam Armstrong,eng ENG,"FW,MF",Southampton,25,1997,14.8,14,9,6,5,3,3,10,30.0,7,15,3,12,5,19,6,0,Matches
31,Stuart Armstrong,sct SCO,"MF,FW",Southampton,30,1992,15.6,32,21,15,13,4,14,39,35.9,25,18,0,18,10,42,9,2,Matches
32,Kepa Arrizabalaga,es ESP,GK,Chelsea,27,1994,28.5,2,2,2,0,0,2,3,66.7,1,0,0,0,1,3,16,2,Matches
33,Pierre-Emerick Aubameyang,ga GAB,FW,Chelsea,33,1989,6.2,1,0,1,0,0,0,1,0.0,1,2,0,2,2,3,4,2,Matches
34,Ludwig Augustinsson,se SWE,DF,Aston Villa,28,1994,0.9,1,1,1,0,0,0,0,,0,0,0,0,0,1,1,0,Matches
35,Serge Aurier,ci CIV,DF,Nott'ham Forest,29,1992,21.6,64,41,41,18,5,23,33,69.7,10,34,11,23,29,93,75,0,Matches
36,Taiwo Awoniyi,ng NGA,FW,Nott'ham Forest,24,1997,15.6,17,10,2,10,5,6,12,50.0,6,18,4,14,4,21,20,0,Matches
37,Yasin Ayari,se SWE,MF,Brighton,18,2003,0.7,2,2,1,1,0,0,4,0.0,4,1,0,1,0,2,0,0,Matches
38,André Ayew,gh GHA,"FW,MF",Nott'ham Forest,32,1989,3.5,5,3,0,4,1,2,4,50.0,2,6,1,5,0,5,7,0,Matches
39,Jordan Ayew,gh GHA,"FW,MF",Crystal Palace,30,1991,30.2,66,41,23,20,23,21,53,39.6,32,35,4,31,15,81,31,0,Matches
40,Luke Ayling,eng ENG,DF,Leeds United,30,1991,22.8,66,37,42,15,9,42,85,49.4,43,34,11,23,26,92,52,2,Matches
41,César Azpilicueta,es ESP,DF,Chelsea,32,1989,17.0,43,25,23,15,5,22,37,59.5,15,26,5,21,19,62,54,1,Matches
42,Benoît Badiashile,fr FRA,DF,Chelsea,21,2001,10.1,14,8,10,4,0,9,14,64.3,5,5,2,3,16,30,34,1,Matches
43,Leon Bailey,jm JAM,"FW,MF",Aston Villa,24,1997,21.9,14,6,6,7,1,5,20,25.0,15,13,0,13,6,20,12,0,Matches
44,Stefan Bajcetic,es ESP,MF,Liverpool,17,2004,5.8,9,6,5,3,1,8,27,29.6,19,7,0,7,9,18,4,0,Matches
45,Dominic Ballard,eng ENG,"FW,MF",Southampton,17,2005,0.3,0,0,0,0,0,0,0,,0,0,0,0,1,1,0,0,Matches
46,Patrick Bamford,eng ENG,FW,Leeds United,28,1993,16.8,9,6,0,6,3,4,20,20.0,16,12,5,7,5,14,13,0,Matches
47,Shandon Baptiste,gd GRN,MF,Brentford,24,1998,6.9,15,9,6,6,3,7,17,41.2,10,10,2,8,7,22,10,0,Matches
48,Harvey Barnes,eng ENG,"FW,MF",Leicester City,24,1997,30.1,26,14,8,14,4,14,42,33.3,28,32,1,31,8,34,12,0,Matches
49,Gavin Bazunu,ie IRL,GK,Southampton,20,2002,32.0,1,0,1,0,0,1,1,100.0,0,0,0,0,1,2,24,2,Matches
50,Mads Bech Sørensen,dk DEN,"DF,MF",Brentford,23,1999,0.2,0,0,0,0,0,0,0,,0,0,0,0,1,1,1,0,Matches
51,Jan Bednarek,pl POL,DF,Southampton,26,1996,18.6,27,21,20,7,0,12,16,75.0,4,38,27,11,49,76,87,0,Matches
52,Jan Bednarek,pl POL,DF,Aston Villa,26,1996,1.1,3,3,0,3,0,1,1,100.0,0,3,1,2,2,5,5,0,Matches
53,Donny van de Beek,nl NED,MF,Manchester Utd,25,1997,1.9,0,0,0,0,0,0,1,0.0,1,2,1,1,1,1,1,0,Matches
54,Asmir Begović,ba BIH,GK,Everton,35,1987,1.0,0,0,0,0,0,0,0,,0,0,0,0,0,0,1,0,Matches
55,Armel Bella Kotchap,de GER,DF,Southampton,20,2001,20.9,37,17,28,9,0,15,20,75.0,5,29,12,17,44,81,110,0,Matches
56,Saïd Benrahma,dz ALG,"FW,MF",West Ham,26,1995,23.0,25,15,11,7,7,11,27,40.7,16,23,1,22,9,34,13,0,Matches
57,Rodrigo Bentancur,uy URU,MF,Tottenham,25,1997,16.7,45,28,15,21,9,16,28,57.1,12,28,15,13,20,65,22,0,Matches
58,Daniel Bentley,eng ENG,GK,Wolves,29,1993,2.0,1,1,1,0,0,1,1,100.0,0,0,0,0,0,1,0,1,Matches
59,Victor Bernth Kristiansen,dk DEN,DF,Leicester City,19,2002,9.9,38,23,18,16,4,22,30,73.3,8,16,4,12,3,41,26,1,Matches
60,Owen Bevan,wls WAL,DF,Bournemouth,18,2003,0.1,0,0,0,0,0,0,0,,0,0,0,0,0,0,0,0,Matches
61,Giulian Biancone,fr FRA,DF,Nott'ham Forest,22,2000,0.2,2,1,2,0,0,1,1,100.0,0,0,0,0,1,3,0,0,Matches
62,Philip Billing,dk DEN,"MF,FW",Bournemouth,26,1996,30.7,63,36,21,33,9,11,42,26.2,31,48,8,40,31,94,58,1,Matches
63,Yves Bissouma,ml MLI,MF,Tottenham,25,1996,11.2,16,13,6,6,4,2,7,28.6,5,15,6,9,12,28,10,0,Matches
64,Willy Boly,ci CIV,DF,Nott'ham Forest,31,1991,7.6,13,6,8,3,2,8,13,61.5,5,13,4,9,12,25,45,0,Matches
65,Sven Botman,nl NED,DF,Newcastle Utd,22,2000,34.7,38,24,31,7,0,22,28,78.6,6,44,24,20,34,72,126,2,Matches
66,Jarrod Bowen,eng ENG,"FW,MF",West Ham,25,1996,35.9,39,16,14,11,14,16,58,27.6,42,47,9,38,36,75,25,0,Matches
67,James Bree,eng ENG,DF,Southampton,24,1997,4.1,5,3,4,1,0,3,4,75.0,1,3,1,2,6,11,11,0,Matches
68,Armando Broja,al ALB,FW,Chelsea,20,2001,3.3,4,1,0,3,1,1,1,100.0,0,10,1,9,1,5,1,0,Matches
69,David Brooks,wls WAL,"FW,MF",Bournemouth,25,1997,1.9,1,0,1,0,0,0,1,0.0,1,2,0,2,2,3,5,0,Matches
70,Lewis Brunt,eng ENG,DF,Leicester City,21,2000,0.3,0,0,0,0,0,0,0,,0,0,0,0,0,0,2,0,Matches
71,Emi Buendía,ar ARG,"MF,FW",Aston Villa,25,1996,26.8,52,23,20,20,12,21,74,28.4,53,20,2,18,20,72,17,0,Matches
72,Hugo Bueno,es ESP,DF,Wolves,19,2002,14.6,33,16,23,6,4,17,33,51.5,16,14,1,13,10,43,36,0,Matches
73,Facundo Buonanotte,ar ARG,"FW,MF",Brighton,17,2004,6.3,2,1,1,1,0,1,22,4.5,21,5,2,3,4,6,3,0,Matches
74,Dan Burn,eng ENG,DF,Newcastle Utd,30,1992,34.6,60,38,29,23,8,34,67,50.7,33,42,16,26,32,92,120,2,Matches
75,Cafú,pt POR,MF,Nott'ham Forest,29,1993,0.1,0,0,0,0,0,0,0,,0,0,0,0,0,0,1,0,Matches
76,Moisés Caicedo,ec ECU,MF,Brighton,20,2001,34.9,100,50,41,47,12,40,68,58.8,28,43,7,36,56,156,31,3,Matches
77,Tom Cairney,sct SCO,MF,Fulham,31,1991,11.0,17,6,4,8,5,7,10,70.0,3,18,3,15,5,22,3,0,Matches
78,Duje Ćaleta-Car,hr CRO,DF,Southampton,25,1996,10.5,14,10,9,4,1,6,9,66.7,3,15,11,4,15,29,65,1,Matches
79,Dominic Calvert-Lewin,eng ENG,FW,Everton,25,1997,12.9,4,2,1,0,3,1,5,20.0,4,5,1,4,3,7,18,0,Matches
80,Chem Campbell,wls WAL,"FW,MF",Wolves,19,2002,0.8,2,1,1,1,0,0,1,0.0,1,2,0,2,1,3,0,0,Matches
81,João Cancelo,pt POR,DF,Manchester City,28,1994,14.2,29,21,16,9,4,17,24,70.8,7,7,1,6,19,48,9,1,Matches
82,Thomas Cannon,ie IRL,FW,Everton,19,2002,0.3,0,0,0,0,0,0,0,,0,0,0,0,0,0,0,0,Matches
83,Sergi Canós,es ESP,"FW,DF",Brentford,25,1997,0.9,0,0,0,0,0,0,2,0.0,2,3,1,2,0,0,1,0,Matches
84,Diego Carlos,br BRA,DF,Aston Villa,29,1993,2.3,1,0,0,1,0,0,1,0.0,1,2,2,0,1,2,2,0,Matches
85,Fabio Carvalho,pt POR,"MF,FW",Liverpool,19,2002,3.9,8,8,3,3,2,3,6,50.0,3,6,0,6,6,14,0,0,Matches
86,Casemiro,br BRA,MF,Manchester Utd,30,1992,23.6,88,46,43,35,10,47,92,51.1,45,49,11,38,34,122,64,0,Matches
87,Matty Cash,pl POL,DF,Aston Villa,24,1997,20.2,55,32,36,15,4,26,37,70.3,11,20,5,15,26,81,43,0,Matches
88,Timothy Castagne,be BEL,DF,Leicester City,26,1995,36.2,87,44,53,27,7,41,84,48.8,43,50,13,37,43,130,110,0,Matches
89,Jonny Castro,es ESP,DF,Wolves,28,1994,14.0,33,15,22,10,1,17,38,44.7,21,26,5,21,14,47,28,2,Matches
90,Nathaniel Chalobah,eng ENG,MF,Fulham,27,1994,0.1,1,1,1,0,0,1,1,100.0,0,0,0,0,0,1,2,0,Matches
91,Trevoh Chalobah,eng ENG,DF,Chelsea,23,1999,17.9,31,20,22,6,3,24,35,68.6,11,17,7,10,24,55,56,1,Matches
92,Calum Chambers,eng ENG,"DF,MF",Aston Villa,27,1995,3.9,9,6,7,2,0,6,8,75.0,2,5,4,1,7,16,10,1,Matches
93,Shea Charles,nir NIR,DF,Manchester City,18,2003,0.3,4,0,4,0,0,1,1,100.0,0,0,0,0,1,5,2,0,Matches
94,Ben Chilwell,eng ENG,"DF,MF",Chelsea,25,1996,15.6,21,17,12,8,1,13,25,52.0,12,21,2,19,18,39,26,0,Matches
95,Ryan Christie,sct SCO,"MF,FW",Bournemouth,27,1995,20.4,34,22,10,23,1,14,50,28.0,36,16,4,12,26,60,20,0,Matches
96,Carney Chukwuemeka,eng ENG,"MF,FW",Chelsea,18,2003,3.9,13,7,7,6,0,3,5,60.0,2,7,0,7,6,19,1,0,Matches
97,Bobby Clark,eng ENG,MF,Liverpool,17,2005,0.1,0,0,0,0,0,0,0,,0,2,0,2,0,0,0,0,Matches
98,Nathaniel Clyne,eng ENG,DF,Crystal Palace,31,1991,18.2,27,16,13,9,5,14,23,60.9,9,22,4,18,19,46,34,0,Matches
99,Conor Coady,eng ENG,DF,Everton,29,1993,23.3,14,9,8,6,0,7,15,46.7,8,21,17,4,14,28,88,3,Matches
100,Jack Colback,eng ENG,MF,Nott'ham Forest,32,1989,5.5,18,13,12,6,0,5,8,62.5,3,3,0,3,3,21,9,0,Matches
101,Séamus Coleman,ie IRL,DF,Everton,33,1988,18.4,35,26,21,10,4,19,29,65.5,10,14,7,7,22,57,58,2,Matches
102,Nathan Collins,ie IRL,DF,Wolves,21,2001,20.2,27,15,19,8,0,15,24,62.5,9,35,28,7,21,48,84,0,Matches
103,Levi Colwill,eng ENG,DF,Brighton,19,2003,13.6,8,7,4,4,0,4,9,44.4,5,5,3,2,15,23,37,1,Matches
104,Lewis Cook,eng ENG,MF,Bournemouth,25,1997,19.1,37,22,10,22,5,18,44,40.9,26,29,10,19,23,60,31,0,Matches
105,Steve Cook,eng ENG,DF,Nott'ham Forest,31,1991,10.6,8,4,4,4,0,5,7,71.4,2,16,11,5,12,20,51,0,Matches
106,Liam Cooper,sct SCO,DF,Leeds United,30,1991,15.8,38,23,27,9,2,23,36,63.9,13,16,8,8,34,72,57,3,Matches
107,Maxwel Cornet,ci CIV,FW,West Ham,25,1996,2.7,7,3,5,0,2,4,6,66.7,2,6,0,6,2,9,3,0,Matches
108,Diego Costa,es ESP,FW,Wolves,33,1988,13.8,3,1,3,0,0,2,9,22.2,7,6,1,5,2,5,17,0,Matches
109,Vladimír Coufal,cz CZE,DF,West Ham,29,1992,23.7,58,31,37,15,6,36,51,70.6,15,24,6,18,38,96,70,0,Matches
110,Philippe Coutinho,br BRA,"MF,FW",Aston Villa,30,1992,8.8,19,14,8,8,3,9,15,60.0,6,11,1,10,4,23,2,0,Matches
111,Conor Coventry,ie IRL,"MF,FW",West Ham,22,2000,0.0,0,0,0,0,0,0,0,,0,0,0,0,0,0,0,0,Matches
112,Matthew Craig,sct SCO,MF,Tottenham,19,2003,0.2,4,1,2,2,0,0,0,,0,0,0,0,0,4,0,0,Matches
113,Aaron Cresswell,eng ENG,DF,West Ham,32,1989,24.8,21,11,12,7,2,12,31,38.7,19,21,11,10,27,48,56,0,Matches
114,Marc Cucurella,es ESP,DF,Chelsea,24,1998,18.6,66,33,40,15,11,30,60,50.0,30,28,8,20,16,82,48,1,Matches
115,Matheus Cunha,br BRA,FW,Wolves,23,1999,10.7,7,4,0,5,2,2,10,20.0,8,15,3,12,9,16,11,0,Matches
116,Patson Daka,zm ZAM,FW,Leicester City,23,1998,13.2,14,8,6,8,0,3,13,23.1,10,14,2,12,7,21,7,0,Matches
117,Diogo Dalot,pt POR,DF,Manchester Utd,23,1999,23.9,54,41,40,13,1,33,45,73.3,12,25,7,18,37,91,55,2,Matches
118,Mikkel Damsgaard,dk DEN,"MF,FW",Brentford,22,2000,11.0,31,21,13,13,5,15,42,35.7,27,20,2,18,10,41,14,0,Matches
119,Danilo,br BRA,MF,Nott'ham Forest,21,2001,10.8,18,7,7,9,2,6,25,24.0,19,26,6,20,9,27,19,0,Matches
120,Arnaut Danjuma,nl NED,"FW,MF",Tottenham,25,1997,1.9,2,0,1,1,0,0,0,,0,1,0,1,0,2,0,0,Matches
121,Josh Dasilva,eng ENG,MF,Brentford,23,1998,15.4,18,9,6,6,6,6,15,40.0,9,22,6,16,5,23,7,1,Matches
122,David Datro Fofana,ci CIV,FW,Chelsea,19,2002,0.8,3,1,1,1,1,1,1,100.0,0,1,0,1,0,3,0,0,Matches
123,Ben Davies,wls WAL,DF,Tottenham,29,1993,25.4,28,11,13,13,2,14,26,53.8,12,17,8,9,18,46,72,0,Matches
124,Tom Davies,eng ENG,MF,Everton,24,1998,6.0,15,9,5,9,1,7,14,50.0,7,10,1,9,4,19,7,1,Matches
125,Craig Dawson,eng ENG,DF,West Ham,32,1990,8.0,11,7,9,2,0,5,7,71.4,2,9,6,3,6,17,26,0,Matches
126,Craig Dawson,eng ENG,DF,Wolves,32,1990,15.7,9,6,6,3,0,4,7,57.1,3,31,23,8,12,21,74,2,Matches
127,Kevin De Bruyne,be BEL,MF,Manchester City,31,1991,26.9,28,12,3,12,13,14,39,35.9,25,27,2,25,9,37,10,0,Matches
128,Siriki Dembélé,ci CIV,"FW,MF",Bournemouth,25,1996,1.2,3,1,2,1,0,0,1,0.0,1,1,0,1,1,4,1,0,Matches
129,Leander Dendoncker,be BEL,MF,Aston Villa,27,1995,7.7,19,9,11,6,2,11,22,50.0,11,19,4,15,10,29,12,0,Matches
130,Leander Dendoncker,be BEL,MF,Wolves,27,1995,2.4,4,2,0,3,1,2,3,66.7,1,2,0,2,9,13,4,0,Matches
131,Emmanuel Dennis,ng NGA,"FW,MF",Nott'ham Forest,24,1997,8.0,17,11,5,5,7,8,18,44.4,10,13,1,12,2,19,6,0,Matches
132,Halil Dervişoğlu,tr TUR,MF,Brentford,22,1999,0.1,0,0,0,0,0,0,1,0.0,1,0,0,0,0,0,0,0,Matches
133,Kiernan Dewsbury-Hall,eng ENG,MF,Leicester City,23,1998,25.6,53,29,14,34,5,19,47,40.4,28,55,13,42,28,81,21,0,Matches
134,Ibrahima Diallo,fr FRA,MF,Southampton,23,1999,9.1,25,15,14,10,1,8,14,57.1,6,11,1,10,6,31,11,0,Matches
135,Rúben Dias,pt POR,DF,Manchester City,25,1997,22.2,21,13,10,10,1,11,18,61.1,7,21,13,8,18,39,56,1,Matches
136,Luis Díaz,co COL,FW,Liverpool,25,1997,11.1,17,11,4,8,5,8,15,53.3,7,8,0,8,6,23,2,0,Matches
137,Eric Dier,eng ENG,DF,Tottenham,28,1994,31.3,30,19,16,12,2,9,19,47.4,10,41,24,17,35,65,112,2,Matches
138,Lucas Digne,fr FRA,DF,Aston Villa,29,1993,16.7,30,12,20,9,1,20,33,60.6,13,18,5,13,18,48,45,0,Matches
139,Issa Diop,fr FRA,DF,Fulham,25,1997,22.4,28,19,18,9,1,17,32,53.1,15,24,17,7,35,63,86,0,Matches
140,Moussa Djenepo,ml MLI,"DF,FW",Southampton,24,1998,7.9,19,11,13,5,1,11,27,40.7,16,19,2,17,11,30,7,0,Matches
141,Ben Doak,sct SCO,FW,Liverpool,16,2005,0.3,3,2,1,2,0,1,1,100.0,0,1,0,1,0,3,0,0,Matches
142,Matt Doherty,ie IRL,"DF,MF",Tottenham,30,1992,7.4,16,10,12,3,1,8,10,80.0,2,11,6,5,8,24,14,1,Matches
143,Abdoulaye Doucouré,ml MLI,MF,Everton,29,1993,17.0,31,20,9,15,7,12,37,32.4,25,26,3,23,13,44,11,0,Matches
144,Cheick Doucouré,ml MLI,MF,Crystal Palace,22,2000,30.8,77,46,40,33,4,29,52,55.8,23,47,13,34,56,133,48,0,Matches
145,Flynn Downes,eng ENG,MF,West Ham,23,1999,8.5,16,9,4,10,2,6,12,50.0,6,15,2,13,7,23,6,0,Matches
146,Kami Doyle,eng ENG,MF,Southampton,16,2005,0.1,0,0,0,0,0,0,0,,0,0,0,0,0,0,0,0,Matches
147,Cody Drameh,eng ENG,DF,Leeds United,20,2001,0.8,5,4,0,4,1,2,3,66.7,1,0,0,0,1,6,1,0,Matches
148,Martin Dúbravka,sk SVK,GK,Newcastle Utd,33,1989,1.7,0,0,0,0,0,0,1,0.0,1,0,0,0,0,0,1,0,Matches
149,Shane Duffy,ie IRL,"DF,FW",Fulham,30,1992,0.2,0,0,0,0,0,0,0,,0,0,0,0,0,0,0,1,Matches
150,Lewis Dunk,eng ENG,DF,Brighton,30,1991,36.0,30,19,19,9,2,18,41,43.9,23,37,27,10,34,64,81,1,Matches
151,Jáder Durán,co COL,"FW,MF",Aston Villa,18,2003,1.5,2,2,0,1,1,1,4,25.0,3,0,0,0,2,4,2,0,Matches
152,Malcolm Ebiowei,eng ENG,"MF,FW",Crystal Palace,18,2003,0.4,1,1,1,0,0,0,1,0.0,1,2,0,2,0,1,0,0,Matches
153,Ederson,br BRA,GK,Manchester City,28,1993,35.0,3,1,3,0,0,1,2,50.0,1,0,0,0,1,4,10,2,Matches
154,Odsonne Édouard,fr FRA,FW,Crystal Palace,24,1998,20.0,25,13,7,12,6,7,13,53.8,6,17,5,12,3,28,22,0,Matches
155,Samuel Edozie,eng ENG,"FW,MF",Southampton,19,2003,6.3,17,10,6,10,1,3,8,37.5,5,7,0,7,6,23,6,0,Matches
156,Anthony Elanga,se SWE,FW,Manchester Utd,20,2002,4.7,3,0,0,2,1,1,2,50.0,1,4,0,4,2,5,4,0,Matches
157,Harvey Elliott,eng ENG,"MF,FW",Liverpool,19,2003,17.9,27,18,6,12,9,9,37,24.3,28,26,1,25,15,42,8,0,Matches
158,Mohamed Elneny,eg EGY,MF,Arsenal,30,1992,1.3,1,1,1,0,0,1,1,100.0,0,0,0,0,0,1,0,0,Matches
159,Mohamed Elyounoussi,no NOR,"MF,FW",Southampton,27,1994,24.1,46,28,22,20,4,19,44,43.2,25,40,3,37,27,73,37,0,Matches
160,Emerson,br BRA,DF,Tottenham,23,1999,19.3,54,33,38,12,4,27,40,67.5,13,17,3,14,18,72,75,0,Matches
161,Julio Enciso,py PAR,"FW,MF",Brighton,18,2004,9.0,13,4,3,6,4,8,13,61.5,5,9,0,9,4,17,2,0,Matches
162,Christian Eriksen,dk DEN,MF,Manchester Utd,30,1992,22.8,22,18,10,7,5,10,33,30.3,23,23,9,14,11,33,20,1,Matches
163,Pervis Estupiñán,ec ECU,DF,Brighton,24,1998,29.7,61,31,36,19,6,35,60,58.3,25,30,8,22,37,98,37,1,Matches
164,Jonny Evans,nir NIR,DF,Leicester City,34,1988,11.7,13,5,12,1,0,7,11,63.6,4,15,11,4,18,31,51,0,Matches
165,Eberechi Eze,eng ENG,"MF,FW",Crystal Palace,24,1998,29.3,42,24,17,18,7,18,38,47.4,20,22,0,22,13,55,10,0,Matches
166,Łukasz Fabiański,pl POL,GK,West Ham,37,1985,34.6,2,0,2,0,0,1,2,50.0,1,1,0,1,0,2,10,1,Matches
167,Fabinho,br BRA,MF,Liverpool,28,1993,29.7,65,38,18,40,7,24,62,38.7,38,38,11,27,37,102,40,0,Matches
168,Wout Faes,be BEL,DF,Leicester City,24,1998,31.0,56,33,28,26,2,28,44,63.6,16,53,37,16,41,97,113,2,Matches
169,Felipe,br BRA,DF,Nott'ham Forest,33,1989,15.8,42,23,29,13,0,24,41,58.5,17,34,13,21,36,78,90,0,Matches
170,João Félix,pt POR,"FW,MF",Chelsea,22,1999,10.5,14,7,5,6,3,4,12,33.3,8,3,0,3,1,15,1,1,Matches
171,Evan Ferguson,ie IRL,FW,Brighton,17,2004,10.6,6,3,1,3,2,1,7,14.3,6,11,1,10,2,8,6,0,Matches
172,Bruno Fernandes,pt POR,"MF,FW",Manchester Utd,27,1994,36.8,68,42,24,25,19,30,71,42.3,41,37,5,32,25,93,40,1,Matches
173,Enzo Fernández,ar ARG,MF,Chelsea,21,2001,17.2,45,27,25,17,3,21,56,37.5,35,32,2,30,16,61,12,1,Matches
174,Roberto Firmino,br BRA,"FW,MF",Liverpool,30,1991,13.5,17,12,2,12,3,4,22,18.2,18,16,1,15,7,24,2,0,Matches
175,Junior Firpo,do DOM,DF,Leeds United,25,1996,15.2,47,25,27,15,5,24,46,52.2,22,23,7,16,24,71,40,0,Matches
176,Phil Foden,eng ENG,FW,Manchester City,22,2000,20.5,16,10,9,5,2,8,19,42.1,11,25,2,23,5,21,12,0,Matches
177,Wesley Fofana,fr FRA,DF,Leicester City,21,2000,2.0,4,2,1,2,1,1,3,33.3,2,1,1,0,9,13,5,0,Matches
178,Wesley Fofana,fr FRA,DF,Chelsea,21,2000,13.1,30,18,19,7,4,13,26,50.0,13,17,10,7,20,50,33,2,Matches
179,Pablo Fornals,es ESP,"FW,MF",West Ham,26,1996,16.7,30,15,9,12,9,13,34,38.2,21,16,2,14,14,44,9,0,Matches
180,Adam Forshaw,eng ENG,MF,Leeds United,30,1991,5.3,12,9,5,7,0,7,17,41.2,10,9,1,8,4,16,2,0,Matches
181,Fraser Forster,eng ENG,GK,Tottenham,34,1988,13.5,1,0,1,0,0,0,0,,0,1,0,1,0,1,3,1,Matches
182,Tyrese Francois,au AUS,FW,Fulham,22,2000,0.0,0,0,0,0,0,0,1,0.0,1,0,0,0,0,0,1,0,Matches
183,Ryan Fraser,sct SCO,FW,Newcastle Utd,28,1994,3.5,2,2,0,0,2,2,5,40.0,3,3,1,2,0,2,3,0,Matches
184,Fred,br BRA,MF,Manchester Utd,29,1993,13.9,47,30,24,20,3,15,38,39.5,23,38,2,36,19,66,19,0,Matches
185,Ryan Fredericks,eng ENG,DF,Bournemouth,29,1992,5.9,3,2,2,0,1,1,4,25.0,3,7,2,5,1,4,27,0,Matches
186,Remo Freuler,ch SUI,MF,Nott'ham Forest,30,1992,24.0,43,23,23,15,5,19,43,44.2,24,36,9,27,29,72,45,0,Matches
187,Cody Gakpo,nl NED,"FW,MF",Liverpool,23,1999,16.2,26,15,4,13,9,13,38,34.2,25,13,1,12,4,30,2,0,Matches
188,Conor Gallagher,eng ENG,MF,Chelsea,22,2000,18.0,46,33,17,19,10,10,37,27.0,27,41,10,31,23,69,18,1,Matches
189,Idrissa Gana Gueye,sn SEN,MF,Everton,32,1989,28.6,97,57,49,35,13,31,62,50.0,31,50,12,38,56,153,34,3,Matches
190,Alejandro Garnacho,ar ARG,"FW,MF",Manchester Utd,18,2004,6.3,5,2,2,0,3,1,11,9.1,10,5,0,5,5,10,3,0,Matches
191,James Garner,eng ENG,"MF,DF",Everton,21,2001,8.9,16,13,4,8,4,9,19,47.4,10,9,1,8,12,28,13,0,Matches
192,David de Gea,es ESP,GK,Manchester Utd,31,1990,38.0,0,0,0,0,0,0,1,0.0,1,0,0,0,1,1,15,3,Matches
193,Joe Gelhardt,eng ENG,FW,Leeds United,20,2002,2.4,6,2,1,3,2,3,5,60.0,2,5,0,5,0,6,4,0,Matches
194,Saman Ghoddos,ir IRN,"MF,FW",Brentford,28,1993,1.5,2,1,0,1,1,1,3,33.3,2,5,1,4,4,6,2,0,Matches
195,Morgan Gibbs-White,eng ENG,"FW,MF",Wolves,22,2000,2.0,3,1,3,0,0,2,4,50.0,2,2,0,2,1,4,3,0,Matches
196,Morgan Gibbs-White,eng ENG,"MF,FW",Nott'ham Forest,22,2000,33.0,26,14,7,7,12,11,33,33.3,22,23,4,19,14,40,15,0,Matches
197,Bryan Gil,es ESP,"MF,FW",Tottenham,21,2001,1.6,3,1,3,0,0,0,3,0.0,3,3,0,3,1,4,1,0,Matches
198,Billy Gilmour,sct SCO,MF,Brighton,21,2001,5.6,5,2,2,2,1,2,8,25.0,6,5,2,3,6,11,5,0,Matches
199,Wilfried Gnonto,it ITA,"FW,MF",Leeds United,18,2003,15.0,27,17,7,15,5,10,30,33.3,20,24,1,23,5,32,7,0,Matches
200,Ben Godfrey,eng ENG,DF,Everton,24,1998,8.9,20,11,13,5,2,11,29,37.9,18,12,6,6,8,28,33,1,Matches
201,João Gomes,br BRA,MF,Wolves,21,2001,7.3,29,13,14,14,1,13,23,56.5,10,12,3,9,4,33,11,0,Matches
202,Toti Gomes,pt POR,DF,Wolves,23,1999,10.9,15,9,11,4,0,9,13,69.2,4,16,8,8,11,26,51,0,Matches
203,Joe Gomez,eng ENG,DF,Liverpool,25,1997,16.3,28,21,15,11,2,11,19,57.9,8,17,11,6,24,52,51,2,Matches
204,Sergio Gómez,es ESP,"DF,MF",Manchester City,21,2000,3.9,9,4,6,1,2,5,8,62.5,3,5,3,2,2,11,9,1,Matches
205,Anthony Gordon,eng ENG,"FW,MF",Newcastle Utd,21,2001,5.4,14,12,5,7,2,9,20,45.0,11,9,1,8,2,16,1,1,Matches
206,Anthony Gordon,eng ENG,FW,Everton,21,2001,12.2,34,22,17,10,7,8,24,33.3,16,19,0,19,4,38,11,0,Matches
207,Demarai Gray,jm JAM,"FW,MF",Everton,26,1996,27.9,33,24,9,14,10,17,31,54.8,14,23,3,20,13,46,18,0,Matches
208,Jack Grealish,eng ENG,FW,Manchester City,26,1995,22.8,25,16,10,12,3,13,23,56.5,10,17,3,14,7,32,9,0,Matches
209,Sam Greenwood,eng ENG,"MF,FW",Leeds United,20,2002,4.7,15,7,7,8,0,8,21,38.1,13,10,2,8,1,16,1,0,Matches
210,Pascal Groß,de GER,"MF,DF",Brighton,31,1991,36.0,59,38,23,27,9,25,55,45.5,30,32,10,22,13,72,21,1,Matches
211,Vicente Guaita,es ESP,GK,Crystal Palace,35,1987,27.0,0,0,0,0,0,0,0,,0,0,0,0,0,0,9,1,Matches
212,Gonçalo Guedes,pt POR,"FW,MF",Wolves,25,1996,7.9,8,6,4,3,1,5,8,62.5,3,4,0,4,1,9,2,0,Matches
213,Marc Guéhi,eng ENG,DF,Crystal Palace,22,2000,37.0,52,27,39,11,2,26,42,61.9,16,45,24,21,45,97,134,3,Matches
214,Bruno Guimarães,br BRA,MF,Newcastle Utd,24,1997,30.3,78,40,27,46,5,38,65,58.5,27,28,4,24,36,114,22,1,Matches
215,İlkay Gündoğan,de GER,MF,Manchester City,31,1990,26.1,30,18,7,13,10,12,34,35.3,22,18,3,15,20,50,13,0,Matches
216,Darko Gyabi,eng ENG,FW,Leeds United,18,2004,0.1,2,2,1,1,0,0,0,,0,2,0,2,0,2,0,0,Matches
217,Erling Haaland,no NOR,FW,Manchester City,22,2000,30.8,3,2,0,2,1,1,5,20.0,4,12,4,8,3,6,14,0,Matches
218,Lewis Hall,eng ENG,DF,Chelsea,17,2004,7.3,23,12,19,4,0,15,22,68.2,7,8,0,8,11,34,11,1,Matches
219,Luke Harris,wls WAL,"MF,FW",Fulham,17,2005,0.1,0,0,0,0,0,0,0,,0,0,0,0,0,0,0,0,Matches
220,Jack Harrison,eng ENG,"FW,MF",Leeds United,25,1996,30.1,41,17,5,15,21,12,52,23.1,40,47,2,45,22,63,25,0,Matches
221,Kai Havertz,de GER,"FW,MF",Chelsea,23,1999,28.5,34,16,4,20,10,10,30,33.3,20,28,0,28,7,41,41,0,Matches
222,Jan Paul van Hecke,nl NED,DF,Brighton,22,2000,3.3,8,6,3,4,1,5,5,100.0,0,8,5,3,6,14,9,0,Matches
223,Hwang Hee-chan,kr KOR,"FW,MF",Wolves,26,1996,12.6,20,9,7,8,5,6,20,30.0,14,18,2,16,5,25,5,0,Matches
224,Dean Henderson,eng ENG,GK,Nott'ham Forest,25,1997,18.0,0,0,0,0,0,0,0,,0,0,0,0,0,0,12,1,Matches
225,Jordan Henderson,eng ENG,MF,Liverpool,32,1990,23.0,32,23,10,18,4,15,36,41.7,21,21,3,18,21,53,16,1,Matches
226,Wayne Hennessey,wls WAL,GK,Nott'ham Forest,35,1987,3.0,1,0,1,0,0,1,1,100.0,0,0,0,0,0,1,2,0,Matches
227,Rico Henry,eng ENG,DF,Brentford,25,1997,36.0,57,31,20,28,9,22,41,53.7,19,29,8,21,30,87,84,1,Matches
228,Son Heung-min,kr KOR,"MF,FW",Tottenham,30,1992,32.1,24,12,7,8,9,9,30,30.0,21,23,2,21,13,37,6,0,Matches
229,Aaron Hickey,sct SCO,DF,Brentford,20,2002,21.3,38,26,27,11,0,18,32,56.3,14,18,7,11,17,55,32,1,Matches
230,Jack Hinshelwood,eng ENG,FW,Brighton,17,2005,0.0,1,0,1,0,0,0,0,,0,0,0,0,0,1,0,0,Matches
231,Joseph Hodge,ie IRL,MF,Wolves,19,2002,1.9,5,2,1,3,1,3,4,75.0,1,5,0,5,0,5,2,1,Matches
232,Rob Holding,eng ENG,DF,Arsenal,26,1995,6.3,8,5,4,4,0,3,6,50.0,3,6,5,1,3,11,27,1,Matches
233,Mason Holgate,eng ENG,DF,Everton,25,1996,5.6,11,7,8,3,0,3,11,27.3,8,7,3,4,7,18,28,0,Matches
234,Will Hughes,eng ENG,MF,Crystal Palace,27,1995,9.4,29,16,11,16,2,11,20,55.0,9,16,7,9,16,45,9,0,Matches
235,Omari Hutchinson,eng ENG,FW,Chelsea,18,2003,0.3,0,0,0,0,0,0,0,,0,0,0,0,1,1,0,0,Matches
236,Pierre Højbjerg,dk DEN,MF,Tottenham,26,1995,34.8,56,30,28,22,6,26,67,38.8,41,46,17,29,49,105,64,1,Matches
237,Kelechi Iheanacho,ng NGA,"FW,MF",Leicester City,25,1996,12.5,7,2,0,3,4,3,10,30.0,7,9,1,8,0,7,8,0,Matches
238,Danny Ings,eng ENG,FW,West Ham,30,1992,8.6,9,8,0,4,5,5,14,35.7,9,8,2,6,3,12,5,0,Matches
239,Danny Ings,eng ENG,FW,Aston Villa,30,1992,9.2,10,5,1,6,3,1,6,16.7,5,12,1,11,1,11,11,0,Matches
240,Alexander Isak,se SWE,FW,Newcastle Utd,22,1999,16.9,18,8,4,7,7,10,28,35.7,18,21,2,19,4,22,8,0,Matches
241,Daniel Iversen,dk DEN,GK,Leicester City,25,1997,12.0,0,0,0,0,0,0,0,,0,0,0,0,0,0,6,1,Matches
242,Alex Iwobi,ng NGA,"MF,FW",Everton,26,1996,37.5,69,37,37,28,4,33,65,50.8,32,41,2,39,25,94,29,0,Matches
243,Daniel James,wls WAL,FW,Leeds United,24,1997,2.2,6,2,1,3,2,3,6,50.0,3,4,0,4,2,8,2,0,Matches
244,Daniel James,wls WAL,FW,Fulham,24,1997,6.9,10,6,4,5,1,4,9,44.4,5,5,1,4,1,11,5,0,Matches
245,Reece James,eng ENG,"DF,MF",Chelsea,22,1999,13.8,31,20,10,18,3,15,19,78.9,4,17,2,15,12,43,23,0,Matches
246,Vitaly Janelt,de GER,"MF,DF",Brentford,24,1998,24.5,54,27,20,24,10,21,49,42.9,28,29,9,20,29,83,26,0,Matches
247,Pontus Jansson,se SWE,DF,Brentford,31,1991,8.0,5,3,4,1,0,3,5,60.0,2,13,9,4,9,14,38,0,Matches
248,Mathias Jensen,dk DEN,MF,Brentford,26,1996,31.1,71,36,29,30,12,34,97,35.1,63,54,5,49,32,103,24,1,Matches
249,Gabriel Jesus,br BRA,FW,Arsenal,25,1997,22.9,33,25,16,8,9,15,31,48.4,16,27,3,24,11,44,15,1,Matches
250,Raúl Jiménez,mx MEX,FW,Wolves,31,1991,9.4,9,6,3,5,1,3,6,50.0,3,9,0,9,0,9,8,0,Matches
251,Joelinton,br BRA,"MF,FW",Newcastle Utd,25,1996,29.6,70,49,36,26,8,26,62,41.9,36,52,7,45,48,118,39,0,Matches
252,Ben Johnson,eng ENG,DF,West Ham,22,2000,9.6,20,14,12,4,4,12,18,66.7,6,12,4,8,9,29,28,1,Matches
253,Brennan Johnson,wls WAL,"FW,MF",Nott'ham Forest,21,2001,32.6,34,20,18,8,8,8,29,27.6,21,30,1,29,5,39,7,1,Matches
254,Sam Johnstone,eng ENG,GK,Crystal Palace,29,1993,9.0,0,0,0,0,0,0,0,,0,0,0,0,0,0,5,0,Matches
255,Curtis Jones,eng ENG,MF,Liverpool,21,2001,11.5,34,17,8,12,14,18,31,58.1,13,12,2,10,3,37,9,0,Matches
256,Jorginho,it ITA,MF,Arsenal,30,1991,9.5,18,13,6,10,2,5,24,20.8,19,7,2,5,9,27,8,0,Matches
257,Jorginho,it ITA,MF,Chelsea,30,1991,14.2,42,23,22,14,6,22,46,47.8,24,18,3,15,21,63,7,0,Matches
258,Mateo Joseph,es ESP,"FW,MF",Leeds United,18,2003,0.3,0,0,0,0,0,0,0,,0,1,0,1,0,0,1,0,Matches
259,Diogo Jota,pt POR,FW,Liverpool,25,1996,12.6,23,15,8,8,7,12,37,32.4,25,5,0,5,3,26,11,0,Matches
260,Hamed Junior Traorè,ci CIV,"FW,MF",Bournemouth,22,2000,4.7,17,11,5,9,3,6,18,33.3,12,9,0,9,2,19,1,0,Matches
261,James Justin,eng ENG,DF,Leicester City,24,1998,13.9,20,18,7,12,1,9,18,50.0,9,24,6,18,15,35,47,0,Matches
262,Mathias Jørgensen,dk DEN,DF,Brentford,32,1990,12.3,17,8,9,8,0,9,21,42.9,12,19,12,7,16,33,39,1,Matches
263,Sasa Kalajdzic,at AUT,FW,Wolves,25,1997,0.5,0,0,0,0,0,0,0,,0,0,0,0,1,1,0,0,Matches
264,Boubacar Kamara,fr FRA,MF,Aston Villa,22,1999,19.7,58,25,25,23,10,27,56,48.2,29,38,12,26,19,77,24,3,Matches
265,Harry Kane,eng ENG,FW,Tottenham,29,1993,37.8,15,12,1,6,8,7,21,33.3,14,27,7,20,2,17,18,0,Matches
266,N'Golo Kanté,fr FRA,MF,Chelsea,31,1991,5.8,16,10,4,10,2,4,8,50.0,4,11,0,11,6,22,2,0,Matches
267,Michael Keane,eng ENG,DF,Everton,29,1993,10.9,7,4,5,2,0,5,8,62.5,3,12,7,5,14,21,55,1,Matches
268,Neeskens Kebano,cd COD,FW,Fulham,30,1992,8.5,17,9,8,6,3,9,18,50.0,9,14,0,14,1,18,8,0,Matches
269,Thilo Kehrer,de GER,DF,West Ham,25,1996,24.8,43,24,25,14,4,21,45,46.7,24,16,6,10,34,77,76,1,Matches
270,Naby Keïta,gn GUI,MF,Liverpool,27,1995,3.3,5,4,2,3,0,1,4,25.0,3,1,0,1,2,7,3,0,Matches
271,Caoimhín Kelleher,ie IRL,GK,Liverpool,23,1998,1.0,0,0,0,0,0,0,0,,0,0,0,0,0,0,0,0,Matches
272,Lloyd Kelly,eng ENG,DF,Bournemouth,23,1998,22.7,33,18,23,9,1,13,19,68.4,6,26,15,11,26,59,101,1,Matches
273,Max Kilman,eng ENG,DF,Wolves,25,1997,36.7,36,20,26,9,1,16,30,53.3,14,70,42,28,19,55,164,1,Matches
274,Jakub Kiwior,pl POL,DF,Arsenal,22,2000,4.7,7,5,6,1,0,5,8,62.5,3,5,3,2,6,13,10,0,Matches
275,Mateusz Klich,pl POL,"MF,FW",Leeds United,32,1990,3.1,12,8,3,4,5,7,13,53.8,6,4,0,4,0,12,1,0,Matches
276,Robin Koch,de GER,DF,Leeds United,26,1996,35.3,53,30,32,16,5,24,56,42.9,32,44,21,23,43,96,152,1,Matches
277,Ibrahima Konaté,fr FRA,DF,Liverpool,23,1999,17.2,38,26,25,13,0,16,27,59.3,11,12,5,7,26,64,61,4,Matches
278,Ezri Konsa,eng ENG,DF,Aston Villa,24,1997,36.9,42,20,25,15,2,18,26,69.2,8,41,23,18,26,68,120,3,Matches
279,Kalidou Koulibaly,sn SEN,DF,Chelsea,31,1991,20.0,45,31,34,8,3,26,40,65.0,14,30,13,17,29,74,77,0,Matches
280,Cheikhou Kouyaté,sn SEN,MF,Nott'ham Forest,32,1989,9.8,29,21,18,8,3,9,13,69.2,4,14,2,12,10,39,24,0,Matches
281,Mateo Kovačić,hr CRO,MF,Chelsea,28,1994,19.0,36,24,16,14,6,14,36,38.9,22,10,1,9,19,55,16,0,Matches
282,Emil Krafth,se SWE,DF,Newcastle Utd,27,1994,0.0,0,0,0,0,0,0,0,,0,0,0,0,0,0,0,0,Matches
283,Rasmus Kristensen,dk DEN,DF,Leeds United,25,1997,21.8,62,35,35,21,6,42,76,55.3,34,32,14,18,35,97,61,0,Matches
284,Dejan Kulusevski,se SWE,"MF,FW",Tottenham,22,2000,23.0,38,15,23,7,8,16,44,36.4,28,19,0,19,13,51,7,0,Matches
285,Layvin Kurzawa,fr FRA,DF,Fulham,29,1992,1.5,3,2,1,1,1,3,3,100.0,0,1,1,0,2,5,4,0,Matches
286,Adam Lallana,eng ENG,"MF,FW",Brighton,34,1988,8.0,9,4,6,2,1,0,7,0.0,7,6,0,6,2,11,1,0,Matches
287,Tariq Lamptey,gh GHA,DF,Brighton,21,2000,5.0,11,6,6,4,1,5,7,71.4,2,7,3,4,7,18,2,0,Matches
288,Manuel Lanzini,ar ARG,"MF,FW",West Ham,29,1993,2.8,2,2,1,1,0,2,6,33.3,4,2,0,2,2,4,0,0,Matches
289,Aymeric Laporte,es ESP,DF,Manchester City,28,1994,11.0,11,8,6,4,1,7,11,63.6,4,10,4,6,3,14,30,1,Matches
290,Juan Larios,es ESP,DF,Southampton,18,2004,1.7,7,6,6,1,0,5,5,100.0,0,2,0,2,3,10,4,0,Matches
291,Jamaal Lascelles,eng ENG,DF,Newcastle Utd,28,1993,2.4,1,0,1,0,0,1,1,100.0,0,3,2,1,0,1,17,0,Matches
292,Roméo Lavia,be BEL,MF,Southampton,18,2004,24.7,60,35,27,29,4,21,53,39.6,32,47,11,36,33,93,23,1,Matches
293,Dexter Lembikisa,jm JAM,DF,Wolves,18,2003,0.3,0,0,0,0,0,0,0,,0,0,0,0,0,0,0,0,Matches
294,Mario Lemina,ga GAB,MF,Wolves,28,1993,14.4,38,24,22,13,3,20,38,52.6,18,26,8,18,14,52,24,1,Matches
295,Clément Lenglet,fr FRA,DF,Tottenham,27,1995,22.4,38,23,18,15,5,16,34,47.1,18,26,11,15,18,56,68,2,Matches
296,Bernd Leno,de GER,GK,Fulham,30,1992,36.0,0,0,0,0,0,0,3,0.0,3,0,0,0,0,0,18,1,Matches
297,Jefferson Lerma,co COL,MF,Bournemouth,27,1994,36.1,50,30,23,23,4,20,45,44.4,25,32,15,17,47,97,91,2,Matches
298,Jamal Lewis,nir NIR,"DF,FW",Newcastle Utd,24,1998,0.1,0,0,0,0,0,0,0,,0,0,0,0,0,0,0,0,Matches
299,Rico Lewis,eng ENG,"DF,MF",Manchester City,17,2004,10.0,16,9,9,5,2,6,11,54.5,5,8,4,4,6,22,13,1,Matches
300,Keane Lewis-Potter,eng ENG,"FW,MF",Brentford,21,2001,3.6,1,0,0,1,0,0,0,,0,5,1,4,0,1,2,0,Matches
301,Victor Lindelöf,se SWE,DF,Manchester Utd,28,1994,15.2,22,17,10,9,3,9,17,52.9,8,18,9,9,21,43,63,1,Matches
302,Jesse Lingard,eng ENG,"FW,MF",Nott'ham Forest,29,1992,10.3,4,4,2,2,0,1,7,14.3,6,11,0,11,5,9,4,0,Matches
303,Valentino Livramento,eng ENG,"DF,FW",Southampton,19,2002,0.3,2,1,2,0,0,0,0,,0,0,0,0,2,4,3,0,Matches
304,Diego Llorente,es ESP,DF,Leeds United,28,1993,7.2,13,10,8,5,0,4,8,50.0,4,6,2,4,15,28,24,2,Matches
305,Hugo Lloris,fr FRA,GK,Tottenham,35,1986,24.5,1,1,1,0,0,1,3,33.3,2,0,0,0,1,2,13,5,Matches
306,Renan Lodi,br BRA,DF,Nott'ham Forest,24,1998,24.6,52,39,38,8,6,33,66,50.0,33,25,6,19,33,85,74,0,Matches
307,Ruben Loftus-Cheek,eng ENG,"MF,DF",Chelsea,26,1996,17.1,25,14,8,14,3,12,22,54.5,10,15,2,13,12,37,23,0,Matches
308,Sean Longstaff,eng ENG,MF,Newcastle Utd,24,1997,28.0,42,21,16,20,6,20,52,38.5,32,35,8,27,16,58,23,0,Matches
309,Jamal Lowe,jm JAM,"MF,FW",Bournemouth,28,1994,0.1,0,0,0,0,0,0,0,,0,0,0,0,0,0,0,0,Matches
310,Douglas Luiz,br BRA,MF,Aston Villa,24,1998,32.5,72,42,31,32,9,29,63,46.0,34,36,7,29,40,112,27,2,Matches
311,Saša Lukić,rs SRB,MF,Fulham,25,1996,4.6,8,3,1,4,3,3,7,42.9,4,6,2,4,5,13,3,0,Matches
312,Lyanco,br BRA,DF,Southampton,25,1997,13.1,24,16,15,9,0,12,18,66.7,6,30,25,5,20,44,65,2,Matches
313,Alexis Mac Allister,ar ARG,MF,Brighton,23,1998,32.1,70,39,22,40,8,34,71,47.9,37,26,2,24,22,92,10,1,Matches
314,James Maddison,eng ENG,"MF,FW",Leicester City,25,1996,27.6,51,26,25,19,7,19,50,38.0,31,19,1,18,13,64,6,1,Matches
315,Noni Madueke,eng ENG,FW,Chelsea,20,2002,7.1,12,8,5,4,3,6,13,46.2,7,13,2,11,4,16,7,0,Matches
316,Gabriel Magalhães,br BRA,DF,Arsenal,24,1997,37.9,48,30,29,15,4,18,27,66.7,9,49,26,23,32,80,125,3,Matches
317,Harry Maguire,eng ENG,DF,Manchester Utd,29,1993,8.5,8,6,6,1,1,4,5,80.0,1,18,11,7,13,21,41,0,Matches
318,Riyad Mahrez,dz ALG,"FW,MF",Manchester City,31,1991,21.3,30,14,8,13,9,13,39,33.3,26,27,1,26,9,39,5,0,Matches
319,Kobbie Mainoo,eng ENG,MF,Manchester Utd,17,2005,0.1,0,0,0,0,0,0,0,,0,1,1,0,0,0,0,0,Matches
320,Ainsley Maitland-Niles,eng ENG,"DF,MF",Southampton,24,1997,15.6,45,24,23,18,4,28,44,63.6,16,28,7,21,22,67,45,1,Matches
321,Tyrell Malacia,nl NED,DF,Manchester Utd,22,1999,15.5,46,33,33,12,1,14,25,56.0,11,13,3,10,25,71,49,0,Matches
322,Orel Mangala,be BEL,MF,Nott'ham Forest,24,1998,17.2,28,20,16,10,2,12,29,41.4,17,21,7,14,23,51,15,0,Matches
323,Javier Manquillo,es ESP,DF,Newcastle Utd,28,1994,0.4,3,2,2,1,0,2,2,100.0,0,1,0,1,1,4,1,0,Matches
324,Sekou Mara,fr FRA,"FW,MF",Southampton,20,2002,6.2,14,10,5,8,1,3,9,33.3,6,11,0,11,1,15,5,0,Matches
325,Solly March,eng ENG,"FW,DF",Brighton,28,1994,30.2,53,31,16,17,20,8,28,28.6,20,34,3,31,24,77,32,0,Matches
326,Emiliano Marcondes,dk DEN,MF,Bournemouth,27,1995,0.1,0,0,0,0,0,0,0,,0,0,0,0,0,0,1,0,Matches
327,Marquinhos,br BRA,MF,Arsenal,19,2003,0.0,0,0,0,0,0,0,0,,0,0,0,0,0,0,0,0,Matches
328,Anthony Martial,fr FRA,FW,Manchester Utd,26,1995,10.9,5,3,0,2,3,1,4,25.0,3,11,2,9,1,6,4,0,Matches
329,Gabriel Martinelli,br BRA,FW,Arsenal,21,2001,31.0,31,18,13,12,6,9,22,40.9,13,24,1,23,9,40,14,0,Matches
330,Emiliano Martínez,ar ARG,GK,Aston Villa,29,1992,34.9,0,0,0,0,0,0,2,0.0,2,0,0,0,1,1,23,1,Matches
331,Lisandro Martínez,ar ARG,DF,Manchester Utd,24,1998,23.5,54,28,33,18,3,30,43,69.8,13,51,27,24,33,87,103,0,Matches
332,Pape Matar Sarr,sn SEN,"MF,FW",Tottenham,19,2002,2.4,7,6,4,2,1,4,8,50.0,4,3,2,1,6,13,6,0,Matches
333,Jean-Philippe Mateta,fr FRA,FW,Crystal Palace,25,1997,8.6,7,1,2,4,1,1,3,33.3,2,3,1,2,3,10,18,0,Matches
334,Joël Matip,cm CMR,DF,Liverpool,30,1991,12.1,14,8,12,2,0,11,23,47.8,12,8,3,5,21,35,45,3,Matches
335,Neal Maupay,fr FRA,FW,Everton,25,1996,12.4,11,5,3,4,4,2,4,50.0,2,8,0,8,5,16,0,0,Matches
336,Kevin Mbabu,ch SUI,"DF,FW",Fulham,27,1995,1.6,3,2,2,1,0,1,3,33.3,2,2,0,2,3,6,3,0,Matches
337,Bryan Mbeumo,cm CMR,FW,Brentford,22,1999,32.3,26,18,5,13,8,8,42,19.0,34,24,1,23,13,39,21,0,Matches
338,James McArthur,sct SCO,MF,Crystal Palace,34,1987,0.6,1,1,1,0,0,1,1,100.0,0,2,1,1,1,2,2,0,Matches
339,Alex McCarthy,eng ENG,GK,Southampton,32,1989,6.0,0,0,0,0,0,0,1,0.0,1,0,0,0,1,1,3,1,Matches
340,John McGinn,sct SCO,"MF,FW",Aston Villa,27,1994,29.9,66,36,27,29,10,34,71,47.9,37,43,4,39,24,90,19,0,Matches
341,Scott McKenna,sct SCO,DF,Nott'ham Forest,25,1996,17.5,12,7,7,3,2,6,10,60.0,4,20,14,6,12,24,85,1,Matches
342,Weston McKennie,us USA,MF,Leeds United,23,1998,16.0,30,13,5,18,7,10,29,34.5,19,22,3,19,22,52,26,0,Matches
343,Dwight McNeil,eng ENG,"FW,MF",Everton,22,1999,27.8,64,41,35,14,15,27,65,41.5,38,46,7,39,31,95,41,0,Matches
344,Scott McTominay,sct SCO,MF,Manchester Utd,25,1996,12.9,32,19,16,10,6,13,22,59.1,9,15,6,9,14,46,45,1,Matches
345,Ben Mee,eng ENG,DF,Brentford,32,1989,36.3,45,24,28,13,4,20,37,54.1,17,54,42,12,48,93,122,2,Matches
346,Edouard Mendy,sn SEN,GK,Chelsea,30,1992,9.5,0,0,0,0,0,0,0,,0,0,0,0,0,0,3,3,Matches
347,Nampalys Mendy,sn SEN,MF,Leicester City,30,1992,8.4,13,9,7,6,0,8,15,53.3,7,20,4,16,13,26,2,0,Matches
348,Chris Mepham,wls WAL,DF,Bournemouth,24,1997,24.4,45,22,37,8,0,19,30,63.3,11,40,27,13,30,75,152,0,Matches
349,Illan Meslier,fr FRA,GK,Leeds United,22,2000,34.0,2,1,2,0,0,2,4,50.0,2,0,0,0,1,3,30,3,Matches
350,Alex Mighten,eng ENG,FW,Nott'ham Forest,20,2002,0.1,0,0,0,0,0,0,1,0.0,1,0,0,0,0,0,0,0,Matches
351,Lewis Miley,eng ENG,MF,Newcastle Utd,16,2006,0.2,0,0,0,0,0,0,0,,0,1,0,1,0,0,0,0,Matches
352,Luka Milivojević,rs SRB,MF,Crystal Palace,31,1991,5.7,13,7,7,4,2,7,10,70.0,3,13,4,9,12,25,10,1,Matches
353,James Milner,eng ENG,"MF,DF",Liverpool,36,1986,10.1,26,16,11,11,4,15,34,44.1,19,14,2,12,12,38,15,0,Matches
354,Yerry Mina,co COL,DF,Everton,27,1994,6.6,15,8,9,6,0,9,11,81.8,2,7,4,3,6,21,28,0,Matches
355,Tyrone Mings,eng ENG,DF,Aston Villa,29,1993,35.0,15,7,10,5,0,9,20,45.0,11,40,21,19,54,69,163,2,Matches
356,Tyrick Mitchell,eng ENG,DF,Crystal Palace,22,1999,32.1,71,49,43,23,5,30,53,56.6,23,48,11,37,42,113,78,0,Matches
357,Kaoru Mitoma,jp JPN,"FW,MF",Brighton,25,1997,25.8,44,27,15,16,13,20,41,48.8,21,25,0,25,17,61,10,0,Matches
358,Aleksandar Mitrović,rs SRB,FW,Fulham,27,1994,22.3,14,7,8,4,2,5,12,41.7,7,22,5,17,3,17,20,1,Matches
359,Kieffer Moore,wls WAL,FW,Bournemouth,29,1992,14.2,14,11,2,9,3,5,16,31.3,11,12,5,7,1,15,26,0,Matches
360,Andrew Moran,ie IRL,FW,Brighton,18,2003,0.1,0,0,0,0,0,0,0,,0,1,0,1,0,0,0,0,Matches
361,Álex Moreno,es ESP,DF,Aston Villa,29,1993,14.8,23,14,15,5,3,13,36,36.1,23,18,3,15,7,30,37,2,Matches
362,Mason Mount,eng ENG,"MF,FW",Chelsea,23,1999,18.3,33,19,6,16,11,14,27,51.9,13,24,6,18,8,41,9,0,Matches
363,Lucas Moura,br BRA,"MF,DF",Tottenham,29,1992,1.7,8,5,1,3,4,1,4,25.0,3,0,0,0,2,10,1,1,Matches
364,João Moutinho,pt POR,MF,Wolves,35,1986,19.8,51,30,24,21,6,19,46,41.3,27,22,6,16,18,69,20,0,Matches
365,Divin Mubama,eng ENG,FW,West Ham,17,2004,0.4,1,1,1,0,0,0,0,,0,0,0,0,0,1,0,0,Matches
366,Mykhailo Mudryk,ua UKR,"FW,MF",Chelsea,21,2001,7.3,11,9,2,4,5,4,13,30.8,9,7,1,6,0,11,3,0,Matches
367,Jacob Murphy,eng ENG,FW,Newcastle Utd,27,1995,13.9,15,7,3,8,4,8,20,40.0,12,17,0,17,7,22,3,0,Matches
368,Enock Mwepu,zm ZAM,"FW,MF",Brighton,24,1998,2.4,10,5,1,6,3,3,4,75.0,1,3,1,2,1,11,1,0,Matches
369,Vitaliy Mykolenko,ua UKR,DF,Everton,23,1999,29.5,58,34,36,19,3,28,51,54.9,23,50,16,34,46,104,99,0,Matches
370,Keylor Navas,cr CRC,GK,Nott'ham Forest,35,1986,17.0,0,0,0,0,0,0,0,,0,0,0,0,1,1,11,2,Matches
371,Wilfred Ndidi,ng NGA,MF,Leicester City,25,1996,18.7,61,42,34,24,3,17,43,39.5,26,32,14,18,38,99,48,3,Matches
372,Reiss Nelson,eng ENG,FW,Arsenal,22,1999,2.4,4,1,2,1,1,2,4,50.0,2,3,0,3,0,4,4,0,Matches
373,Neto,br BRA,GK,Bournemouth,33,1989,26.5,3,1,3,0,0,3,3,100.0,0,0,0,0,0,3,10,3,Matches
374,Pedro Neto,pt POR,"FW,MF",Wolves,22,2000,10.7,11,6,4,2,5,7,17,41.2,10,5,1,4,4,15,4,0,Matches
375,Rúben Neves,pt POR,MF,Wolves,25,1997,33.5,79,43,31,33,15,32,76,42.1,44,59,22,37,50,129,85,1,Matches
376,Moussa Niakhate,sn SEN,DF,Nott'ham Forest,26,1996,12.9,18,9,15,3,0,11,22,50.0,11,18,8,10,19,37,60,0,Matches
377,Eddie Nketiah,eng ENG,FW,Arsenal,23,1999,12.1,13,9,6,2,5,2,10,20.0,8,7,1,6,1,14,7,0,Matches
378,Matheus Nunes,pt POR,MF,Wolves,23,1998,27.4,67,43,36,22,9,28,61,45.9,33,35,4,31,16,83,35,2,Matches
379,Darwin Núñez,uy URU,FW,Liverpool,23,1999,18.8,11,5,2,4,5,4,17,23.5,13,10,0,10,3,14,13,0,Matches
380,Ethan Nwaneri,eng ENG,FW,Arsenal,15,2007,0.0,0,0,0,0,0,0,0,,0,1,0,1,0,0,0,0,Matches
381,Christian Nørgaard,dk DEN,MF,Brentford,28,1994,19.6,52,30,21,29,2,18,48,37.5,30,32,9,23,34,86,41,2,Matches
382,Lewis O'Brien,eng ENG,MF,Nott'ham Forest,23,1998,6.5,16,9,4,11,1,6,12,50.0,6,13,2,11,5,21,9,0,Matches
383,Odeluga Offiah,eng ENG,DF,Brighton,19,2002,0.3,1,1,1,0,0,0,2,0.0,2,0,0,0,0,1,1,0,Matches
384,Angelo Ogbonna,it ITA,DF,West Ham,34,1988,13.7,11,4,7,4,0,5,10,50.0,5,11,7,4,17,28,74,1,Matches
385,Michael Olise,fr FRA,"FW,MF",Crystal Palace,20,2001,30.5,58,34,28,26,4,25,60,41.7,35,46,1,45,26,84,17,0,Matches
386,Robin Olsen,se SWE,GK,Aston Villa,32,1990,3.1,0,0,0,0,0,0,2,0.0,2,0,0,0,0,0,1,0,Matches
387,Amadou Onana,be BEL,MF,Everton,20,2001,27.6,72,43,24,42,6,30,42,71.4,12,25,6,19,37,109,39,0,Matches
388,Josh Onomah,eng ENG,MF,Fulham,25,1997,0.2,1,0,1,0,0,0,0,,0,1,0,1,0,1,0,0,Matches
389,Paul Onuachu,ng NGA,FW,Southampton,28,1994,4.5,3,2,1,1,1,1,3,33.3,2,4,1,3,0,3,4,0,Matches
390,Frank Onyeka,ng NGA,MF,Brentford,24,1998,9.4,19,14,11,7,1,10,24,41.7,14,16,3,13,10,29,16,0,Matches
391,Mislav Oršić,hr CRO,MF,Southampton,29,1992,0.1,1,1,1,0,0,0,0,,0,0,0,0,0,1,0,0,Matches
392,Stefan Ortega,de GER,GK,Manchester City,29,1992,3.0,0,0,0,0,0,0,0,,0,0,0,0,0,0,0,0,Matches
393,Dango Ouattara,bf BFA,"MF,FW",Bournemouth,20,2002,13.8,28,15,20,6,2,13,32,40.6,19,20,3,17,13,41,29,1,Matches
394,Alex Oxlade-Chamberlain,eng ENG,"FW,MF",Liverpool,28,1993,3.7,5,4,1,2,2,1,5,20.0,4,5,2,3,1,6,4,0,Matches
395,David Ozoh,eng ENG,FW,Crystal Palace,17,2005,0.0,0,0,0,0,0,0,0,,0,0,0,0,0,0,0,0,Matches
396,João Palhinha,pt POR,MF,Fulham,27,1995,34.5,148,83,59,65,24,71,135,52.6,64,48,5,43,46,194,61,2,Matches
397,Cole Palmer,eng ENG,"MF,FW",Manchester City,20,2002,4.1,5,1,0,3,2,3,5,60.0,2,2,1,1,1,6,2,0,Matches
398,Emerson Palmieri,it ITA,DF,West Ham,27,1994,14.7,26,14,9,15,2,12,24,50.0,12,17,4,13,15,41,36,0,Matches
399,Lucas Paquetá,br BRA,MF,West Ham,24,1997,23.9,71,53,23,36,12,27,68,39.7,41,41,4,37,16,87,31,0,Matches
400,Thomas Partey,gh GHA,MF,Arsenal,29,1993,27.6,70,40,20,35,15,25,52,48.1,27,26,5,21,28,98,41,1,Matches
401,Nathan Patterson,sct SCO,"DF,MF",Everton,20,2001,14.2,49,24,32,13,4,29,54,53.7,25,24,4,20,15,64,45,0,Matches
402,Ben Pearson,eng ENG,MF,Bournemouth,27,1995,3.2,7,3,3,3,1,1,3,33.3,2,4,0,4,2,9,6,0,Matches
403,Facundo Pellistri,uy URU,"FW,MF",Manchester Utd,20,2001,0.7,1,1,0,1,0,0,0,,0,0,0,0,0,1,3,0,Matches
404,Andreas Pereira,br BRA,MF,Fulham,26,1996,29.9,18,9,3,6,9,8,34,23.5,26,21,3,18,6,24,8,0,Matches
405,Ricardo Pereira,pt POR,"DF,MF",Leicester City,28,1993,5.0,11,7,8,3,0,7,17,41.2,10,8,2,6,4,15,20,0,Matches
406,Ayoze Pérez,es ESP,"MF,FW",Leicester City,29,1993,4.2,11,8,5,4,2,8,19,42.1,11,6,0,6,2,13,3,0,Matches
407,Ivan Perišić,hr CRO,"DF,MF",Tottenham,33,1989,23.4,42,24,25,10,7,27,47,57.4,20,29,7,22,22,64,49,1,Matches
408,Romain Perraud,fr FRA,DF,Southampton,24,1997,20.4,54,33,23,23,8,28,52,53.8,24,24,6,18,20,74,42,0,Matches
409,Máximo Perrone,ar ARG,MF,Manchester City,19,2003,0.2,0,0,0,0,0,0,0,,0,1,0,1,0,0,0,0,Matches
410,Cameron Peupion,au AUS,MF,Brighton,19,2002,0.1,0,0,0,0,0,0,0,,0,0,0,0,0,0,0,0,Matches
411,Kalvin Phillips,eng ENG,MF,Manchester City,26,1995,3.3,6,4,3,3,0,2,10,20.0,8,7,3,4,5,11,10,0,Matches
412,Nathaniel Phillips,eng ENG,DF,Liverpool,25,1997,0.7,2,1,0,2,0,2,2,100.0,0,0,0,0,2,4,1,0,Matches
413,Jordan Pickford,eng ENG,GK,Everton,28,1994,37.0,0,0,0,0,0,0,1,0.0,1,0,0,0,4,4,15,3,Matches
414,Ethan Pinnock,jm JAM,DF,Brentford,29,1993,30.0,52,28,33,12,7,18,24,75.0,6,41,31,10,35,87,215,2,Matches
415,Daniel Podence,pt POR,"FW,MF",Wolves,26,1995,19.7,27,17,13,9,5,6,32,18.8,26,19,0,19,7,34,6,0,Matches
416,Nick Pope,eng ENG,GK,Newcastle Utd,30,1992,36.2,1,0,1,0,0,1,3,33.3,2,0,0,0,0,1,27,2,Matches
417,Pedro Porro,es ESP,"DF,MF",Tottenham,22,1999,12.6,25,16,8,15,2,14,39,35.9,25,25,2,23,15,40,24,1,Matches
418,Dennis Praet,be BEL,"MF,FW",Leicester City,28,1994,7.2,12,9,5,6,1,6,11,54.5,5,12,2,10,5,17,6,0,Matches
419,Isaac Price,nir NIR,MF,Everton,18,2003,0.4,0,0,0,0,0,0,1,0.0,1,1,1,0,0,0,0,0,Matches
420,Christian Pulisic,us USA,"FW,DF",Chelsea,23,1998,9.1,11,6,3,6,2,3,5,60.0,2,8,1,7,4,15,4,0,Matches
421,Aaron Ramsdale,eng ENG,GK,Arsenal,24,1998,38.0,1,1,1,0,0,1,1,100.0,0,0,0,0,0,1,20,6,Matches
422,Jacob Ramsey,eng ENG,"MF,FW",Aston Villa,21,2001,29.3,69,39,23,35,11,32,69,46.4,37,48,8,40,23,92,34,0,Matches
423,Marcus Rashford,eng ENG,FW,Manchester Utd,24,1997,32.0,20,10,7,8,5,9,24,37.5,15,31,4,27,7,27,14,0,Matches
424,David Raya,es ESP,GK,Brentford,26,1995,38.0,0,0,0,0,0,0,2,0.0,2,1,0,1,1,1,10,3,Matches
425,Tim Ream,us USA,DF,Fulham,34,1987,32.2,30,16,15,12,3,13,26,50.0,13,45,24,21,41,71,116,3,Matches
426,Nathan Redmond,eng ENG,DF,Southampton,28,1994,0.0,0,0,0,0,0,0,0,,0,0,0,0,0,0,0,0,Matches
427,Harrison Reed,eng ENG,MF,Fulham,27,1995,31.8,44,27,17,21,6,16,51,31.4,35,54,12,42,19,63,36,0,Matches
428,Bobby Reid,jm JAM,"FW,DF",Fulham,29,1993,27.5,42,24,14,14,14,16,36,44.4,20,25,3,22,20,62,28,1,Matches
429,Declan Rice,eng ENG,MF,West Ham,23,1999,36.4,79,38,44,31,4,31,50,62.0,19,45,15,30,63,142,58,0,Matches
430,Chris Richards,us USA,DF,Crystal Palace,22,2000,5.0,9,6,8,1,0,5,7,71.4,2,10,1,9,8,17,31,0,Matches
431,Richarlison,br BRA,"MF,FW",Tottenham,25,1997,11.2,21,16,13,5,3,12,27,44.4,15,14,1,13,5,26,10,0,Matches
432,Jaïro Riedewald,nl NED,"DF,MF",Crystal Palace,25,1996,0.7,2,1,2,0,0,0,1,0.0,1,2,0,2,0,2,4,0,Matches
433,Matt Ritchie,sct SCO,"FW,MF",Newcastle Utd,32,1989,0.4,1,1,0,1,0,1,3,33.3,2,0,0,0,1,2,0,0,Matches
434,Andrew Robertson,sct SCO,DF,Liverpool,28,1994,28.7,38,21,12,16,10,21,41,51.2,20,32,5,27,18,56,50,3,Matches
435,Antonee Robinson,us USA,DF,Fulham,24,1997,34.3,62,38,43,15,4,44,65,67.7,21,49,13,36,53,115,83,3,Matches
436,Joel Robles,es ESP,GK,Leeds United,32,1990,4.0,0,0,0,0,0,0,1,0.0,1,0,0,0,0,0,2,1,Matches
437,Marc Roca,es ESP,MF,Leeds United,25,1996,25.7,66,40,27,34,5,20,65,30.8,45,34,10,24,23,89,24,2,Matches
438,Marek Rodák,sk SVK,GK,Fulham,25,1996,2.0,0,0,0,0,0,0,0,,0,0,0,0,0,0,1,1,Matches
439,Rodri,es ESP,MF,Manchester City,26,1996,32.3,67,41,28,28,11,26,53,49.1,27,40,14,26,33,100,43,1,Matches
440,Rodrigo,es ESP,"FW,MF",Leeds United,31,1991,21.5,24,10,2,15,7,8,19,42.1,11,16,4,12,6,30,21,1,Matches
441,Mads Roerslev,dk DEN,DF,Brentford,23,1999,12.3,22,12,19,3,0,16,33,48.5,17,14,5,9,9,31,38,0,Matches
442,Cristian Romero,ar ARG,DF,Tottenham,24,1998,26.3,68,36,42,24,2,29,46,63.0,17,40,18,22,44,112,102,3,Matches
443,Oriol Romeu,es ESP,MF,Southampton,30,1991,0.8,1,0,0,1,0,0,0,,0,1,0,1,1,2,1,0,Matches
444,Cristiano Ronaldo,pt POR,FW,Manchester Utd,37,1985,5.8,2,2,1,0,1,1,2,50.0,1,0,0,0,1,3,9,0,Matches
445,Connor Ronan,ie IRL,MF,Wolves,24,1998,0.0,0,0,0,0,0,0,0,,0,0,0,0,0,0,0,0,Matches
446,Salomón Rondón,ve VEN,FW,Everton,32,1989,1.2,0,0,0,0,0,0,0,,0,1,1,0,0,0,0,0,Matches
447,Joe Rothwell,eng ENG,MF,Bournemouth,27,1995,11.3,20,13,7,12,1,7,21,33.3,14,14,3,11,9,29,7,0,Matches
448,Georginio Rutter,fr FRA,"FW,MF",Leeds United,20,2002,3.0,10,9,5,3,2,5,8,62.5,3,5,0,5,3,13,3,0,Matches
449,José Sá,pt POR,GK,Wolves,29,1993,36.0,1,0,1,0,0,1,1,100.0,0,0,0,0,0,1,10,6,Matches
450,Marcel Sabitzer,at AUT,MF,Manchester Utd,28,1994,7.0,12,8,3,8,1,2,11,18.2,9,6,2,4,8,20,11,0,Matches
451,Allan Saint-Maximin,fr FRA,FW,Newcastle Utd,25,1997,12.4,10,3,3,6,1,2,11,18.2,9,4,0,4,5,15,2,0,Matches
452,Bukayo Saka,eng ENG,FW,Arsenal,20,2001,35.3,63,34,22,15,26,20,44,45.5,24,38,0,38,14,77,19,0,Matches
453,Mohamed Salah,eg EGY,FW,Liverpool,30,1992,36.6,21,12,4,5,12,10,26,38.5,16,21,0,21,6,27,4,0,Matches
454,William Saliba,fr FRA,DF,Arsenal,21,2001,26.8,34,20,23,9,2,15,18,83.3,3,13,10,3,19,53,85,4,Matches
455,Mohammed Salisu,gh GHA,DF,Southampton,23,1999,21.9,52,29,34,16,2,24,34,70.6,10,56,25,31,30,82,122,1,Matches
456,Albert Sambi Lokonga,be BEL,MF,Arsenal,22,1999,2.2,1,1,0,0,1,0,2,0.0,2,1,0,1,5,6,2,0,Matches
457,Albert Sambi Lokonga,be BEL,MF,Crystal Palace,22,1999,6.0,13,10,7,4,2,8,12,66.7,4,8,3,5,7,20,10,0,Matches
458,Davinson Sánchez,co COL,DF,Tottenham,26,1996,9.5,24,11,17,6,1,14,20,70.0,6,16,10,6,12,36,41,0,Matches
459,Robert Sánchez,es ESP,GK,Brighton,24,1997,23.0,1,0,1,0,0,0,0,,0,0,0,0,3,4,9,2,Matches
460,Jadon Sancho,eng ENG,"FW,MF",Manchester Utd,22,2000,18.7,16,10,7,5,4,8,28,28.6,20,25,2,23,7,23,6,0,Matches
461,Morgan Sanson,fr FRA,MF,Aston Villa,27,1994,0.1,2,1,1,1,0,1,1,100.0,0,0,0,0,0,2,0,0,Matches
462,Pablo Sarabia,es ESP,"FW,MF",Wolves,30,1992,8.5,12,6,4,5,3,6,15,40.0,9,7,0,7,2,14,4,0,Matches
463,Jeremy Sarmiento,ec ECU,MF,Brighton,20,2002,2.0,6,3,4,1,1,2,5,40.0,3,2,0,2,1,7,0,0,Matches
464,Gianluca Scamacca,it ITA,FW,West Ham,23,1999,10.3,10,5,1,3,6,2,2,100.0,0,3,0,3,4,14,5,0,Matches
465,Gustavo Scarpa,br BRA,"MF,FW",Nott'ham Forest,28,1994,2.0,5,2,3,1,1,2,5,40.0,3,4,0,4,0,5,3,0,Matches
466,Kevin Schade,de GER,FW,Brentford,20,2001,8.1,12,8,7,2,3,5,10,50.0,5,7,0,7,4,16,6,0,Matches
467,Fabian Schär,ch SUI,DF,Newcastle Utd,30,1991,35.6,47,22,31,13,3,24,39,61.5,15,34,19,15,52,99,139,0,Matches
468,Jeffrey Schlupp,gh GHA,"MF,FW",Crystal Palace,29,1992,28.1,66,46,28,29,9,22,43,51.2,21,39,8,31,23,89,38,0,Matches
469,Nélson Semedo,pt POR,DF,Wolves,28,1993,29.2,71,42,48,19,4,33,64,51.6,31,42,15,27,29,100,83,2,Matches
470,Antoine Semenyo,gh GHA,"FW,MF",Bournemouth,22,2000,2.9,1,0,0,0,1,1,6,16.7,5,10,1,9,2,3,4,0,Matches
471,Marcos Senesi,ar ARG,DF,Bournemouth,25,1997,27.7,50,35,28,22,0,23,44,52.3,21,38,20,18,43,93,146,2,Matches
472,Ryan Sessegnon,eng ENG,DF,Tottenham,22,2000,9.0,16,11,9,7,0,6,12,50.0,6,8,1,7,6,22,17,1,Matches
473,Luke Shaw,eng ENG,DF,Manchester Utd,27,1995,28.4,55,36,31,22,2,32,46,69.6,14,51,17,34,36,91,55,2,Matches
474,Jonjo Shelvey,eng ENG,MF,Newcastle Utd,30,1992,0.4,1,0,1,0,0,0,1,0.0,1,1,0,1,0,1,0,0,Matches
475,Jonjo Shelvey,eng ENG,MF,Nott'ham Forest,30,1992,6.0,2,1,0,1,1,1,9,11.1,8,7,2,5,5,7,10,1,Matches
476,Bernardo Silva,pt POR,"MF,FW",Manchester City,27,1994,24.5,44,23,11,25,8,18,45,40.0,27,23,6,17,16,60,6,0,Matches
477,Thiago Silva,br BRA,DF,Chelsea,37,1984,26.1,41,27,24,17,0,21,31,67.7,10,38,29,9,34,75,111,3,Matches
478,Ellis Simms,eng ENG,FW,Everton,21,2001,2.5,0,0,0,0,0,0,0,,0,0,0,0,0,0,1,0,Matches
479,Luis Sinisterra,co COL,FW,Leeds United,23,1999,9.6,21,14,8,9,4,11,18,61.1,7,11,1,10,8,29,2,0,Matches
480,Oliver Skipp,eng ENG,MF,Tottenham,21,2000,16.6,34,17,18,15,1,16,33,48.5,17,17,8,9,17,51,19,1,Matches
481,Adam Smith,eng ENG,DF,Bournemouth,31,1991,32.7,49,29,27,19,3,29,60,48.3,31,30,13,17,25,74,81,1,Matches
482,Emile Smith Rowe,eng ENG,"MF,FW",Arsenal,22,2000,1.9,1,1,1,0,0,1,3,33.3,2,1,0,1,0,1,2,0,Matches
483,Cédric Soares,pt POR,DF,Arsenal,30,1991,0.3,0,0,0,0,0,0,1,0.0,1,1,0,1,0,0,1,0,Matches
484,Cédric Soares,pt POR,DF,Fulham,30,1991,2.2,8,5,4,3,1,3,3,100.0,0,3,1,2,1,9,5,0,Matches
485,Dominic Solanke,eng ENG,"FW,MF",Bournemouth,24,1997,31.8,15,9,8,3,4,5,22,22.7,17,26,7,19,6,21,46,0,Matches
486,Manor Solomon,il ISR,FW,Fulham,23,1999,6.4,20,12,12,6,2,9,16,56.3,7,8,0,8,5,25,3,0,Matches
487,Tomáš Souček,cz CZE,MF,West Ham,27,1995,31.3,77,37,41,29,7,28,58,48.3,30,42,17,25,53,130,71,3,Matches
488,Boubakary Soumaré,fr FRA,MF,Leicester City,23,1999,18.1,57,34,29,26,2,23,44,52.3,21,15,4,11,33,90,27,1,Matches
489,Harry Souttar,au AUS,DF,Leicester City,23,1998,11.0,15,9,10,5,0,7,18,38.9,11,16,12,4,12,27,45,0,Matches
490,Çağlar Söyüncü,tr TUR,DF,Leicester City,26,1996,5.9,14,9,10,4,0,7,10,70.0,3,9,8,1,7,21,30,0,Matches
491,Djed Spence,eng ENG,"FW,DF",Tottenham,21,2000,0.1,0,0,0,0,0,0,0,,0,0,0,0,0,0,0,0,Matches
492,Jack Stacey,eng ENG,DF,Bournemouth,26,1996,3.3,5,4,3,1,1,2,5,40.0,3,3,1,2,5,10,15,0,Matches
493,Junior Stanislas,eng ENG,MF,Bournemouth,32,1989,0.7,0,0,0,0,0,0,0,,0,2,1,1,0,0,0,0,Matches
494,Jay Stansfield,eng ENG,FW,Fulham,19,2002,1.0,0,0,0,0,0,0,2,0.0,2,4,1,3,1,1,1,0,Matches
495,Jason Steele,eng ENG,GK,Brighton,31,1990,15.0,0,0,0,0,0,0,1,0.0,1,0,0,0,0,0,6,1,Matches
496,Jack Stephens,eng ENG,DF,Southampton,28,1994,0.5,2,2,2,0,0,1,1,100.0,0,1,1,0,1,3,2,0,Matches
497,Jack Stephens,eng ENG,DF,Bournemouth,28,1994,13.0,15,11,10,4,1,6,10,60.0,4,23,16,7,16,31,53,0,Matches
498,Raheem Sterling,eng ENG,"FW,MF",Chelsea,27,1994,21.0,18,10,5,4,9,8,14,57.1,6,17,0,17,2,20,5,0,Matches
499,John Stones,eng ENG,"DF,MF",Manchester City,28,1994,20.5,23,13,11,8,4,7,10,70.0,3,17,10,7,9,32,40,0,Matches
500,Pascal Struijk,nl NED,DF,Leeds United,22,1999,24.4,84,57,43,31,10,49,75,65.3,26,32,12,20,32,116,70,1,Matches
501,Kamaldeen Sulemana,gh GHA,"FW,MF",Southampton,20,2002,10.7,15,9,4,7,4,4,14,28.6,10,16,0,16,6,21,6,0,Matches
502,Crysencio Summerville,nl NED,FW,Leeds United,20,2001,15.8,30,20,14,14,2,11,23,47.8,12,20,2,18,13,43,11,0,Matches
503,Sam Surridge,eng ENG,FW,Nott'ham Forest,24,1998,3.6,5,0,1,3,1,1,4,25.0,3,5,2,3,0,5,7,0,Matches
504,Japhet Tanganga,eng ENG,DF,Tottenham,23,1999,1.6,3,2,3,0,0,1,5,20.0,4,1,0,1,2,5,8,0,Matches
505,Matt Targett,eng ENG,DF,Newcastle Utd,26,1995,6.8,13,10,8,3,2,9,24,37.5,15,8,3,5,9,22,16,0,Matches
506,James Tarkowski,eng ENG,DF,Everton,29,1992,38.0,51,26,36,13,2,20,39,51.3,19,99,78,21,51,102,201,3,Matches
507,Marcus Tavernier,eng ENG,"MF,FW",Bournemouth,23,1999,19.4,33,22,19,11,3,11,33,33.3,22,25,4,21,9,42,23,0,Matches
508,Tetê,br BRA,FW,Leicester City,22,2000,8.2,14,8,5,7,2,6,21,28.6,15,9,0,9,2,16,3,0,Matches
509,Kenny Tete,nl NED,DF,Fulham,26,1995,28.5,83,46,41,29,13,38,51,74.5,13,48,17,31,52,135,81,1,Matches
510,Luke Thomas,eng ENG,DF,Leicester City,21,2001,11.9,23,19,15,5,3,15,32,46.9,17,20,4,16,27,50,35,0,Matches
511,Youri Tielemans,be BEL,MF,Leicester City,25,1997,26.0,66,39,27,30,9,23,62,37.1,39,35,8,27,28,94,24,1,Matches
512,Kieran Tierney,sct SCO,DF,Arsenal,25,1997,8.8,20,11,9,9,2,12,16,75.0,4,8,2,6,11,31,25,0,Matches
513,Harry Toffolo,eng ENG,DF,Nott'ham Forest,26,1995,10.4,17,8,10,4,3,10,14,71.4,4,16,8,8,10,27,33,0,Matches
514,Takehiro Tomiyasu,jp JPN,DF,Arsenal,23,1998,7.4,27,18,12,10,5,13,18,72.2,5,7,0,7,14,41,15,1,Matches
515,James Tomkins,eng ENG,DF,Crystal Palace,33,1989,3.8,4,2,2,1,1,1,3,33.3,2,3,2,1,5,9,19,0,Matches
516,Ivan Toney,eng ENG,FW,Brentford,26,1996,32.8,23,13,4,9,10,7,23,30.4,16,24,9,15,14,37,36,0,Matches
517,Adama Traoré,es ESP,"FW,MF",Wolves,26,1996,16.6,14,7,7,4,3,4,9,44.4,5,8,1,7,3,17,17,0,Matches
518,Bertrand Traoré,bf BFA,"FW,MF",Aston Villa,26,1995,2.6,1,1,1,0,0,1,4,25.0,3,5,0,5,2,3,0,0,Matches
519,Boubacar Traoré,ml MLI,MF,Wolves,20,2001,4.6,12,5,4,5,3,3,7,42.9,4,4,2,2,7,19,1,0,Matches
520,Mark Travers,ie IRL,GK,Bournemouth,23,1999,11.5,0,0,0,0,0,0,0,,0,1,0,1,0,0,6,0,Matches
521,Kieran Trippier,eng ENG,DF,Newcastle Utd,31,1990,37.1,71,49,36,27,8,46,90,51.1,44,45,15,30,43,114,84,2,Matches
522,Leandro Trossard,be BEL,FW,Arsenal,27,1994,10.3,12,7,4,2,6,6,18,33.3,12,18,0,18,6,18,3,1,Matches
523,Leandro Trossard,be BEL,"FW,MF",Brighton,27,1994,14.6,10,6,7,1,2,1,8,12.5,7,17,0,17,6,16,1,0,Matches
524,Kostas Tsimikas,gr GRE,DF,Liverpool,26,1996,8.6,14,9,10,2,2,10,16,62.5,6,8,1,7,12,26,15,0,Matches
525,Deniz Undav,de GER,"FW,MF",Brighton,26,1996,7.0,7,4,2,2,3,2,8,25.0,6,4,1,3,0,7,1,0,Matches
526,Yan Valery,tn TUN,DF,Southampton,23,1999,0.5,0,0,0,0,0,0,0,,0,1,0,1,0,0,3,0,Matches
527,Virgil van Dijk,nl NED,DF,Liverpool,31,1991,31.5,27,14,13,11,3,8,19,42.1,11,24,16,8,31,58,138,3,Matches
528,Raphaël Varane,fr FRA,DF,Manchester Utd,29,1993,21.2,24,9,18,6,0,7,17,41.2,10,24,17,7,11,35,91,0,Matches
529,Jamie Vardy,eng ENG,FW,Leicester City,35,1987,20.6,9,5,4,2,3,1,8,12.5,7,17,3,14,2,11,30,0,Matches
530,Joël Veltman,nl NED,DF,Brighton,30,1992,24.3,62,32,44,14,4,37,57,64.9,20,27,8,19,19,81,51,0,Matches
531,Fabio Vieira,pt POR,"MF,FW",Arsenal,22,2000,5.7,6,4,3,0,3,3,5,60.0,2,5,0,5,4,10,2,0,Matches
532,Matías Viña,uy URU,DF,Bournemouth,24,1997,5.1,19,11,9,8,2,14,30,46.7,16,13,1,12,4,23,22,0,Matches
533,Rúben Vinagre,pt POR,"DF,MF",Everton,23,1999,0.3,2,2,1,1,0,1,2,50.0,1,0,0,0,0,2,1,0,Matches
534,Carlos Vinícius,br BRA,FW,Fulham,27,1995,12.3,4,1,0,2,2,0,4,0.0,4,7,0,7,0,4,10,0,Matches
535,Theo Walcott,eng ENG,"FW,MF",Southampton,33,1989,12.5,13,6,8,4,1,8,27,29.6,19,8,1,7,9,22,7,0,Matches
536,Kyle Walker,eng ENG,DF,Manchester City,32,1990,21.8,13,9,8,5,0,4,24,16.7,20,12,2,10,18,31,22,0,Matches
537,Kyle Walker-Peters,eng ENG,DF,Southampton,25,1997,29.4,61,32,34,24,3,22,43,51.2,21,47,8,39,27,88,52,0,Matches
538,Aaron Wan-Bissaka,eng ENG,DF,Manchester Utd,24,1997,15.9,40,25,20,17,3,23,25,92.0,2,24,8,16,22,62,41,0,Matches
539,Danny Ward,wls WAL,GK,Leicester City,29,1993,26.0,1,1,1,0,0,1,3,33.3,2,0,0,0,0,1,14,2,Matches
540,Joel Ward,eng ENG,DF,Crystal Palace,32,1989,25.1,50,36,30,11,9,30,41,73.2,11,32,16,16,25,75,80,1,Matches
541,James Ward-Prowse,eng ENG,MF,Southampton,27,1994,37.5,65,37,31,27,7,21,61,34.4,40,30,10,20,55,120,48,0,Matches
542,Ollie Watkins,eng ENG,FW,Aston Villa,26,1995,34.7,19,13,3,13,3,10,27,37.0,17,21,4,17,10,29,39,0,Matches
543,Adam Webster,eng ENG,DF,Brighton,27,1995,22.1,22,12,10,9,3,11,19,57.9,8,30,19,11,19,41,55,4,Matches
544,Wout Weghorst,nl NED,"FW,MF",Manchester Utd,29,1992,8.9,11,5,6,1,4,2,9,22.2,7,7,2,5,7,18,9,0,Matches
545,Danny Welbeck,eng ENG,FW,Brighton,31,1990,20.6,15,7,0,7,8,4,11,36.4,7,24,2,22,5,20,20,0,Matches
546,Ben White,eng ENG,DF,Arsenal,24,1997,33.9,60,31,23,30,7,42,70,60.0,28,47,11,36,22,82,79,1,Matches
547,Harvey White,eng ENG,MF,Tottenham,20,2001,0.1,0,0,0,0,0,0,1,0.0,1,0,0,0,0,0,0,0,Matches
548,Joseph Whitworth,eng ENG,GK,Crystal Palace,18,2004,2.0,0,0,0,0,0,0,0,,0,0,0,0,0,0,1,0,Matches
549,Neco Williams,wls WAL,DF,Nott'ham Forest,21,2001,20.9,72,47,49,17,6,38,71,53.5,33,33,8,25,33,105,48,0,Matches
550,Willian,br BRA,FW,Fulham,33,1988,23.6,13,8,8,3,2,7,25,28.0,18,13,0,13,9,22,9,0,Matches
551,Joe Willock,eng ENG,MF,Newcastle Utd,22,1999,28.4,51,30,13,26,12,25,58,43.1,33,54,8,46,25,76,17,0,Matches
552,Callum Wilson,eng ENG,FW,Newcastle Utd,30,1992,20.9,9,3,0,8,1,0,3,0.0,3,8,0,8,1,10,5,0,Matches
553,Harry Wilson,wls WAL,FW,Fulham,25,1997,12.2,21,13,9,9,3,8,18,44.4,10,17,2,15,6,27,14,0,Matches
554,Yoane Wissa,cd COD,FW,Brentford,25,1996,17.8,17,12,4,7,6,6,13,46.2,7,10,0,10,6,23,15,0,Matches
555,Maximilian Wöber,at AUT,DF,Leeds United,24,1998,14.1,25,18,9,15,1,16,24,66.7,8,32,14,18,27,52,67,1,Matches
556,Chris Wood,nz NZL,FW,Newcastle Utd,30,1991,5.0,5,4,0,3,2,3,5,60.0,2,2,2,0,1,6,7,0,Matches
557,Chris Wood,nz NZL,FW,Nott'ham Forest,30,1991,4.1,0,0,0,0,0,0,1,0.0,1,2,1,1,1,1,2,0,Matches
558,Joe Worrall,eng ENG,DF,Nott'ham Forest,25,1997,24.7,53,25,39,12,2,25,35,71.4,10,33,23,10,26,79,111,1,Matches
559,Granit Xhaka,ch SUI,MF,Arsenal,29,1992,33.3,34,27,11,18,5,16,41,39.0,25,28,10,18,15,49,45,1,Matches
560,Ryan Yates,eng ENG,MF,Nott'ham Forest,24,1997,20.4,38,19,19,16,3,14,22,63.6,8,26,8,18,10,48,44,0,Matches
561,Ashley Young,eng ENG,DF,Aston Villa,37,1985,22.6,50,27,34,15,1,37,50,74.0,13,25,11,14,21,71,65,0,Matches
562,Illia Zabarnyi,ua UKR,DF,Bournemouth,19,2002,3.3,4,2,4,0,0,3,7,42.9,4,7,2,5,3,7,14,0,Matches
563,Wilfried Zaha,ci CIV,"FW,MF",Crystal Palace,29,1992,25.4,32,20,12,12,8,8,21,38.1,13,21,1,20,16,48,9,0,Matches
564,Denis Zakaria,ch SUI,MF,Chelsea,25,1996,4.6,9,5,5,2,2,2,8,25.0,6,4,1,3,3,12,10,0,Matches
565,Jordan Zemura,zw ZIM,DF,Bournemouth,22,1999,16.2,39,24,24,14,1,23,44,52.3,21,31,9,22,16,55,32,0,Matches
566,Oleksandr Zinchenko,ua UKR,DF,Arsenal,25,1996,23.5,40,18,14,17,9,21,40,52.5,19,20,2,18,22,62,38,2,Matches
567,Hakim Ziyech,ma MAR,"FW,MF",Chelsea,29,1993,7.3,20,12,12,5,3,4,9,44.4,5,8,0,8,5,25,5,1,Matches
568,Kurt Zouma,fr FRA,DF,West Ham,27,1994,22.1,9,4,4,5,0,5,8,62.5,3,17,14,3,30,39,120,1,Matches
569,Martin Ødegaard,no NOR,MF,Arsenal,23,1998,34.7,36,23,12,14,10,14,47,29.8,33,20,5,15,6,42,12,1,Matches
1,Max Aarons,eng ENG,DF,Norwich City,21,2000,32.0,64,44,49,15,0,37,55,67.3,18,39,19,20,28,92,96,1,Matches
2,Che Adams,sct SCO,FW,Southampton,25,1996,22.7,13,6,5,5,3,2,16,12.5,14,18,2,16,8,21,18,0,Matches
3,Rayan Aït-Nouri,dz ALG,"DF,MF",Wolves,20,2001,20.3,64,36,46,15,3,22,44,50.0,22,24,2,22,22,86,39,1,Matches
4,Kristoffer Ajer,no NOR,DF,Brentford,23,1998,22.2,29,18,21,6,2,13,21,61.9,8,19,11,8,26,55,74,0,Matches
5,Nathan Aké,nl NED,DF,Manchester City,26,1995,10.3,16,9,7,8,1,6,8,75.0,2,7,5,2,8,24,23,0,Matches
6,Marc Albrighton,eng ENG,"FW,DF",Leicester City,31,1989,12.6,31,19,16,9,6,10,47,21.3,37,15,3,12,14,45,20,0,Matches
7,Thiago Alcántara,es ESP,MF,Liverpool,30,1991,17.0,48,29,14,24,10,10,42,23.8,32,22,2,20,26,74,13,2,Matches
8,Trent Alexander-Arnold,eng ENG,DF,Liverpool,22,1998,31.7,40,23,19,13,8,27,60,45.0,33,22,4,18,43,83,40,0,Matches
9,Alisson,br BRA,GK,Liverpool,28,1992,36.0,3,1,3,0,0,3,5,60.0,2,1,0,1,0,3,28,1,Matches
10,Allan,br BRA,MF,Everton,30,1991,24.3,74,44,28,39,7,34,105,32.4,71,40,9,31,23,97,39,1,Matches
11,Dele Alli,eng ENG,MF,Tottenham,25,1996,7.3,14,8,10,3,1,5,17,29.4,12,22,5,17,6,20,16,0,Matches
12,Dele Alli,eng ENG,"MF,FW",Everton,25,1996,3.8,7,2,3,4,0,0,4,0.0,4,7,2,5,6,13,10,0,Matches
13,Miguel Almirón,py PAR,"MF,FW",Newcastle Utd,27,1994,19.1,47,29,23,17,7,11,44,25.0,33,14,1,13,20,67,13,0,Matches
14,Marcos Alonso,es ESP,DF,Chelsea,30,1990,24.1,41,29,20,12,9,17,36,47.2,19,29,5,24,43,84,53,0,Matches
15,Steven Alzate,co COL,MF,Brighton,22,1998,4.5,10,4,4,5,1,4,7,57.1,3,2,1,1,10,20,10,0,Matches
16,Daniel Amartey,gh GHA,DF,Leicester City,26,1994,23.6,26,13,19,7,0,19,29,65.5,10,30,22,8,21,47,93,4,Matches
17,Joachim Andersen,dk DEN,DF,Crystal Palace,25,1996,32.4,30,23,21,9,0,16,27,59.3,11,29,19,10,37,67,125,3,Matches
18,Michail Antonio,jm JAM,FW,West Ham,31,1990,33.0,23,17,5,9,9,7,18,38.9,11,19,1,18,3,26,13,0,Matches
19,Cameron Archer,eng ENG,"FW,MF",Aston Villa,20,2001,0.3,0,0,0,0,0,0,0,,0,0,0,0,0,0,0,0,Matches
20,Alphonse Areola,fr FRA,GK,West Ham,28,1993,1.0,0,0,0,0,0,0,0,,0,0,0,0,0,0,1,0,Matches
21,Adam Armstrong,eng ENG,FW,Southampton,24,1997,15.7,10,4,2,2,6,0,6,0.0,6,13,1,12,3,13,6,0,Matches
22,Stuart Armstrong,sct SCO,MF,Southampton,29,1992,16.4,27,19,15,6,6,9,23,39.1,14,10,1,9,8,35,15,0,Matches
23,Kepa Arrizabalaga,es ESP,GK,Chelsea,26,1994,4.0,0,0,0,0,0,0,0,,0,0,0,0,0,0,4,0,Matches
24,Harrison Ashby,sct SCO,DF,West Ham,19,2001,0.1,0,0,0,0,0,0,0,,0,1,0,1,1,1,1,0,Matches
25,Pierre-Emerick Aubameyang,ga GAB,FW,Arsenal,32,1989,11.5,11,5,6,4,1,3,10,30.0,7,12,1,11,0,11,4,0,Matches
26,Jordan Ayew,gh GHA,FW,Crystal Palace,29,1991,22.4,47,30,20,20,7,17,31,54.8,14,33,3,30,15,62,15,0,Matches
27,Luke Ayling,eng ENG,DF,Leeds United,29,1991,25.2,74,42,46,23,5,51,97,52.6,46,46,25,21,28,102,52,1,Matches
28,César Azpilicueta,es ESP,DF,Chelsea,31,1989,23.0,51,28,18,27,6,16,35,45.7,19,32,9,23,23,74,65,1,Matches
29,Daniel Bachmann,at AUT,GK,Watford,27,1994,12.0,0,0,0,0,0,0,0,,0,0,0,0,1,1,5,0,Matches
30,Leon Bailey,jm JAM,"FW,MF",Aston Villa,23,1997,8.5,17,11,6,8,3,6,13,46.2,7,10,1,9,1,18,2,0,Matches
31,Eric Bailly,ci CIV,DF,Manchester Utd,27,1994,2.4,5,4,4,0,1,3,4,75.0,1,4,2,2,3,8,11,0,Matches
32,Folarin Balogun,us USA,FW,Arsenal,20,2001,0.8,1,1,0,0,1,0,0,,0,1,0,1,0,1,1,0,Matches
33,Patrick Bamford,eng ENG,FW,Leeds United,27,1993,6.2,1,0,0,1,0,0,3,0.0,3,8,2,6,2,3,8,0,Matches
34,Shandon Baptiste,gd GRN,MF,Brentford,23,1998,10.1,14,4,9,4,1,6,15,40.0,9,10,0,10,11,25,12,0,Matches
35,Ross Barkley,eng ENG,"MF,FW",Chelsea,27,1993,2.0,0,0,0,0,0,0,1,0.0,1,1,0,1,1,1,0,0,Matches
36,Ashley Barnes,eng ENG,FW,Burnley,31,1989,9.0,11,2,2,7,2,2,9,22.2,7,8,1,7,2,13,5,0,Matches
37,Harvey Barnes,eng ENG,"FW,MF",Leicester City,23,1997,23.3,31,16,9,11,11,7,23,30.4,16,24,1,23,5,36,7,0,Matches
38,Lewis Bate,eng ENG,MF,Leeds United,18,2002,1.6,1,0,0,0,1,0,8,0.0,8,1,0,1,1,2,1,0,Matches
39,Mads Bech Sørensen,dk DEN,DF,Brentford,22,1999,9.3,8,7,6,2,0,6,7,85.7,1,9,6,3,6,14,25,0,Matches
40,Jan Bednarek,pl POL,DF,Southampton,25,1996,29.2,32,15,18,13,1,19,33,57.6,14,48,27,21,72,104,141,0,Matches
41,Donny van de Beek,nl NED,MF,Manchester Utd,24,1997,0.8,6,4,4,1,1,1,2,50.0,1,5,1,4,2,8,1,0,Matches
42,Donny van de Beek,nl NED,MF,Everton,24,1997,5.4,15,7,8,6,1,6,13,46.2,7,6,2,4,6,21,4,0,Matches
43,Asmir Begović,ba BIH,GK,Everton,34,1987,3.0,0,0,0,0,0,0,0,,0,0,0,0,0,0,3,0,Matches
44,Saïd Benrahma,dz ALG,"FW,MF",West Ham,25,1995,24.1,28,17,16,9,3,15,38,39.5,23,17,1,16,9,37,8,0,Matches
45,Rodrigo Bentancur,uy URU,MF,Tottenham,24,1997,15.1,36,18,14,14,8,16,32,50.0,16,24,9,15,20,56,35,0,Matches
46,Christian Benteke,be BEL,FW,Crystal Palace,30,1990,12.7,3,2,1,2,0,2,6,33.3,4,7,3,4,2,5,33,0,Matches
47,Jóhann Berg Guðmundsson,is ISL,MF,Burnley,30,1990,12.2,16,6,7,7,2,5,20,25.0,15,11,2,9,12,28,22,0,Matches
48,Steven Bergwijn,nl NED,"FW,MF",Tottenham,23,1997,6.3,3,2,2,1,0,1,10,10.0,9,3,0,3,1,4,8,0,Matches
49,Ryan Bertrand,eng ENG,DF,Leicester City,31,1989,3.7,8,5,3,4,1,2,5,40.0,3,8,3,5,1,9,7,0,Matches
50,Mads Bidstrup,dk DEN,MF,Brentford,20,2001,0.5,1,0,0,1,0,0,3,0.0,3,0,0,0,1,2,2,0,Matches
51,Yves Bissouma,ml MLI,MF,Brighton,24,1996,23.5,76,49,35,37,4,21,37,56.8,16,33,3,30,50,126,49,0,Matches
52,Willy Boly,ci CIV,DF,Wolves,30,1991,10.0,25,19,18,7,0,8,15,53.3,7,14,6,8,14,39,35,0,Matches
53,Jarrod Bowen,eng ENG,FW,West Ham,24,1996,33.1,36,20,20,11,5,17,44,38.6,27,29,2,27,21,57,14,0,Matches
54,Jarrad Branthwaite,eng ENG,DF,Everton,19,2002,4.3,4,1,3,1,0,3,8,37.5,5,3,2,1,1,5,20,0,Matches
55,Armando Broja,al ALB,FW,Southampton,19,2001,21.9,12,5,2,7,3,2,9,22.2,7,17,1,16,3,15,11,0,Matches
56,Josh Brownhill,eng ENG,MF,Burnley,25,1995,32.8,73,37,25,42,6,21,53,39.6,32,37,12,25,68,141,42,1,Matches
57,Lewis Brunt,eng ENG,MF,Leicester City,20,2000,0.3,0,0,0,0,0,0,0,,0,1,0,1,0,0,0,0,Matches
58,Emi Buendía,ar ARG,"MF,FW",Aston Villa,24,1996,21.1,38,18,16,13,9,21,51,41.2,30,21,3,18,9,47,11,0,Matches
59,Dan Burn,eng ENG,DF,Newcastle Utd,29,1992,16.0,16,11,11,4,1,7,11,63.6,4,22,14,8,20,36,101,0,Matches
60,Dan Burn,eng ENG,DF,Brighton,29,1992,11.4,22,12,13,8,1,6,15,40.0,9,14,10,4,24,46,51,0,Matches
61,Jack Butland,eng ENG,GK,Crystal Palace,28,1993,8.5,0,0,0,0,0,0,0,,0,0,0,0,0,0,1,0,Matches
62,Sam Byram,eng ENG,DF,Norwich City,27,1993,11.4,24,15,17,6,1,19,27,70.4,8,21,11,10,22,46,48,0,Matches
63,Willy Caballero,ar ARG,GK,Southampton,39,1981,2.0,0,0,0,0,0,0,0,,0,0,0,0,0,0,2,1,Matches
64,Moisés Caicedo,ec ECU,MF,Brighton,19,2001,7.3,16,10,7,7,2,5,12,41.7,7,18,4,14,10,26,7,0,Matches
65,Dominic Calvert-Lewin,eng ENG,FW,Everton,24,1997,14.3,11,8,1,6,4,3,8,37.5,5,5,2,3,3,14,12,0,Matches
66,Chem Campbell,wls WAL,MF,Wolves,18,2002,0.1,1,1,0,1,0,0,0,,0,0,0,0,0,1,0,0,Matches
67,João Cancelo,pt POR,DF,Manchester City,27,1994,35.9,83,54,33,35,15,46,91,50.5,45,25,3,22,59,142,45,1,Matches
68,Sergi Canós,es ESP,"DF,FW",Brentford,24,1997,23.1,56,25,32,15,9,33,60,55.0,27,32,3,29,22,78,38,0,Matches
69,Todd Cantwell,eng ENG,"FW,MF",Norwich City,23,1998,4.9,15,13,8,6,1,6,17,35.3,11,2,0,2,3,18,2,0,Matches
70,Matty Cash,pl POL,DF,Aston Villa,23,1997,37.5,89,50,52,34,3,47,78,60.3,31,54,16,38,49,138,100,2,Matches
71,Timothy Castagne,be BEL,DF,Leicester City,25,1995,23.6,67,31,38,22,7,27,43,62.8,16,28,9,19,29,96,54,1,Matches
72,Jonny Castro,es ESP,DF,Wolves,27,1994,11.4,25,15,13,11,1,11,20,55.0,9,14,3,11,13,38,11,0,Matches
73,Craig Cathcart,nir NIR,DF,Watford,32,1989,26.6,32,15,25,6,1,16,30,53.3,14,39,29,10,28,60,132,3,Matches
74,Edinson Cavani,uy URU,FW,Manchester Utd,34,1987,8.5,4,1,0,3,1,2,8,25.0,6,6,0,6,2,6,8,0,Matches
75,Kayky Chagas,br BRA,FW,Manchester City,18,2003,0.1,0,0,0,0,0,0,0,,0,0,0,0,0,0,0,0,Matches
76,Trevoh Chalobah,eng ENG,DF,Chelsea,22,1999,16.1,40,27,22,18,0,24,31,77.4,7,16,6,10,19,59,43,2,Matches
77,Calum Chambers,eng ENG,DF,Arsenal,26,1995,1.9,5,3,3,1,1,3,4,75.0,1,6,3,3,0,5,10,0,Matches
78,Calum Chambers,eng ENG,DF,Aston Villa,26,1995,9.2,16,8,10,6,0,4,6,66.7,2,14,8,6,5,21,42,0,Matches
79,Daniel Chesters,eng ENG,MF,West Ham,19,2002,0.0,0,0,0,0,0,0,0,,0,0,0,0,0,0,0,0,Matches
80,Ben Chilwell,eng ENG,DF,Chelsea,24,1996,6.0,8,3,2,6,0,2,5,40.0,3,7,0,7,4,12,14,1,Matches
81,Chiquinho,pt POR,"DF,FW",Wolves,21,2000,2.3,9,6,4,5,0,4,5,80.0,1,5,0,5,2,11,1,0,Matches
82,Hamza Choudhury,eng ENG,"DF,MF",Leicester City,23,1997,3.2,9,3,4,4,1,3,5,60.0,2,0,0,0,12,21,10,0,Matches
83,Andreas Christensen,dk DEN,DF,Chelsea,25,1996,16.6,14,8,9,4,1,4,7,57.1,3,14,6,8,29,43,57,1,Matches
84,Carney Chukwuemeka,eng ENG,"MF,FW",Aston Villa,17,2003,3.3,7,1,2,5,0,3,5,60.0,2,3,0,3,1,8,2,1,Matches
85,Ciaran Clark,ie IRL,DF,Newcastle Utd,31,1989,11.3,13,10,4,7,2,9,14,64.3,5,14,11,3,13,26,43,1,Matches
86,Tom Cleverley,eng ENG,MF,Watford,31,1989,18.0,37,20,19,17,1,18,33,54.5,15,23,6,17,18,55,19,3,Matches
87,Nathaniel Clyne,eng ENG,DF,Crystal Palace,30,1991,15.0,21,10,11,9,1,10,20,50.0,10,7,2,5,15,36,32,0,Matches
88,Conor Coady,eng ENG,DF,Wolves,28,1993,37.3,31,14,23,7,1,16,28,57.1,12,46,40,6,28,59,140,0,Matches
89,Séamus Coleman,ie IRL,DF,Everton,32,1988,29.5,61,36,35,16,10,33,51,64.7,18,30,11,19,32,93,80,2,Matches
90,Nathan Collins,ie IRL,DF,Burnley,20,2001,18.6,37,15,27,8,2,17,27,63.0,10,38,25,13,24,61,83,2,Matches
91,Aaron Connolly,ie IRL,"FW,MF",Brighton,21,2000,1.7,0,0,0,0,0,0,1,0.0,1,2,0,2,0,0,0,0,Matches
92,Liam Cooper,sct SCO,DF,Leeds United,29,1991,20.2,41,23,27,13,1,23,33,69.7,10,29,18,11,43,84,72,2,Matches
93,Jack Cork,eng ENG,MF,Burnley,32,1989,18.6,20,6,6,11,3,7,20,35.0,13,17,4,13,17,37,29,1,Matches
94,Maxwel Cornet,ci CIV,"FW,MF",Burnley,24,1996,19.6,16,9,7,5,4,7,15,46.7,8,13,4,9,10,26,14,0,Matches
95,Hélder Costa,ao ANG,MF,Leeds United,27,1994,0.2,0,0,0,0,0,0,0,,0,1,0,1,0,0,0,0,Matches
96,Vladimír Coufal,cz CZE,DF,West Ham,28,1992,24.5,45,25,24,14,7,18,36,50.0,18,31,9,22,22,67,64,1,Matches
97,Philippe Coutinho,br BRA,"MF,FW",Aston Villa,29,1992,14.8,17,12,4,11,2,6,21,28.6,15,11,1,10,7,24,4,0,Matches
98,Aaron Cresswell,eng ENG,DF,West Ham,31,1989,30.3,28,18,18,6,4,13,25,52.0,12,31,18,13,35,63,66,0,Matches
99,Charlie Cresswell,eng ENG,DF,Leeds United,18,2002,1.6,5,2,1,4,0,3,3,100.0,0,1,1,0,2,7,6,0,Matches
100,Cucho,co COL,"FW,MF",Watford,22,1999,12.7,13,5,5,5,3,5,27,18.5,22,13,1,12,5,18,9,0,Matches
101,Marc Cucurella,es ESP,DF,Brighton,23,1998,34.3,93,62,43,32,18,44,71,62.0,27,42,14,28,30,123,74,0,Matches
102,Luke Cundle,eng ENG,MF,Wolves,19,2002,2.0,4,3,0,4,0,1,1,100.0,0,0,0,0,1,5,1,0,Matches
103,Patson Daka,zm ZAM,FW,Leicester City,22,1998,12.9,15,10,2,8,5,2,19,10.5,17,7,0,7,2,17,8,0,Matches
104,Stuart Dallas,nir NIR,"DF,MF",Leeds United,30,1991,32.4,93,55,58,31,4,56,105,53.3,49,45,14,31,57,150,63,2,Matches
105,Diogo Dalot,pt POR,DF,Manchester Utd,22,1999,20.0,55,41,35,12,8,31,57,54.4,26,24,13,11,29,84,59,0,Matches
106,Karl Darlow,wls WAL,GK,Newcastle Utd,30,1990,8.0,0,0,0,0,0,0,0,,0,0,0,0,0,0,5,1,Matches
107,Josh Dasilva,eng ENG,"MF,FW",Brentford,22,1998,2.9,2,1,0,1,1,1,2,50.0,1,3,0,3,1,3,7,0,Matches
108,Ben Davies,wls WAL,DF,Tottenham,28,1993,28.2,36,21,20,12,4,13,26,50.0,13,32,19,13,30,66,75,1,Matches
109,Tom Davies,eng ENG,MF,Everton,23,1998,2.6,3,1,1,1,1,2,5,40.0,3,2,1,1,2,5,9,0,Matches
110,Keinan Davis,eng ENG,FW,Aston Villa,23,1998,0.1,0,0,0,0,0,0,0,,0,0,0,0,0,0,0,0,Matches
111,Craig Dawson,eng ENG,DF,West Ham,31,1990,30.6,29,17,20,8,1,14,25,56.0,11,59,52,7,29,58,139,0,Matches
112,Kevin De Bruyne,be BEL,MF,Manchester City,30,1991,24.5,32,16,4,15,13,12,37,32.4,25,32,2,30,6,38,16,0,Matches
113,Troy Deeney,eng ENG,FW,Watford,33,1988,0.3,0,0,0,0,0,0,1,0.0,1,0,0,0,0,0,2,0,Matches
114,Liam Delap,eng ENG,FW,Manchester City,18,2003,0.1,0,0,0,0,0,0,0,,0,0,0,0,0,0,0,0,Matches
115,Fabian Delph,eng ENG,MF,Everton,31,1989,7.4,18,15,10,7,1,8,21,38.1,13,12,5,7,14,32,10,0,Matches
116,Leander Dendoncker,be BEL,MF,Wolves,26,1995,21.7,42,17,25,14,3,22,50,44.0,28,37,10,27,9,51,38,1,Matches
117,Emmanuel Dennis,ng NGA,"FW,MF",Watford,23,1997,28.7,51,35,20,22,9,17,52,32.7,35,36,2,34,15,66,13,0,Matches
118,Kiernan Dewsbury-Hall,eng ENG,MF,Leicester City,22,1998,23.4,39,24,20,14,5,19,40,47.5,21,37,8,29,21,60,26,1,Matches
119,Ibrahima Diallo,fr FRA,MF,Southampton,22,1999,11.4,22,11,10,9,3,10,24,41.7,14,7,0,7,9,31,10,0,Matches
120,Rúben Dias,pt POR,DF,Manchester City,24,1997,26.7,26,19,11,12,3,8,15,53.3,7,19,13,6,23,49,66,0,Matches
121,Luis Díaz,co COL,FW,Liverpool,24,1997,10.6,9,7,3,5,1,2,8,25.0,6,7,0,7,4,13,2,0,Matches
122,Eric Dier,eng ENG,DF,Tottenham,27,1994,34.1,15,9,6,8,1,7,14,50.0,7,37,32,5,27,42,142,1,Matches
123,Lucas Digne,fr FRA,DF,Aston Villa,28,1993,14.1,13,10,8,3,2,9,19,47.4,10,15,8,7,23,36,40,0,Matches
124,Lucas Digne,fr FRA,DF,Everton,28,1993,13.0,33,19,26,4,3,21,28,75.0,7,16,5,11,14,47,30,0,Matches
125,Issa Diop,fr FRA,DF,West Ham,24,1997,10.7,10,8,5,5,0,4,11,36.4,7,14,13,1,7,17,44,0,Matches
126,Moussa Djenepo,ml MLI,MF,Southampton,23,1998,5.1,9,3,3,5,1,3,11,27.3,8,6,1,5,2,11,6,1,Matches
127,Lewis Dobbin,eng ENG,"FW,MF",Everton,18,2003,0.4,2,1,0,1,1,1,2,50.0,1,0,0,0,0,2,0,0,Matches
128,Matt Doherty,ie IRL,DF,Tottenham,29,1992,9.7,18,12,5,11,2,8,14,57.1,6,11,2,9,13,31,20,0,Matches
129,Abdoulaye Doucouré,ml MLI,MF,Everton,28,1993,28.2,75,43,30,37,8,32,71,45.1,39,33,8,25,28,103,32,0,Matches
130,Kieran Dowell,eng ENG,"FW,MF",Norwich City,23,1997,10.1,18,7,8,7,3,9,32,28.1,23,10,1,9,7,25,4,0,Matches
131,Cody Drameh,eng ENG,"DF,MF",Leeds United,19,2001,1.4,4,2,3,1,0,1,3,33.3,2,0,0,0,1,5,4,0,Matches
132,Martin Dúbravka,sk SVK,GK,Newcastle Utd,32,1989,26.0,1,1,1,0,0,0,1,0.0,1,0,0,0,0,1,8,2,Matches
133,Shane Duffy,ie IRL,DF,Brighton,29,1992,16.0,15,12,12,3,0,8,14,57.1,6,24,18,6,16,31,76,1,Matches
134,Paul Dummett,wls WAL,DF,Newcastle Utd,29,1991,2.2,7,3,3,4,0,5,8,62.5,3,5,0,5,3,10,5,0,Matches
135,Lewis Dunk,eng ENG,DF,Brighton,29,1991,28.6,10,8,5,5,0,5,11,45.5,6,32,28,4,27,37,113,3,Matches
136,Ederson,br BRA,GK,Manchester City,27,1993,37.0,2,1,2,0,0,0,2,0.0,2,0,0,0,0,2,12,0,Matches
137,Odsonne Édouard,fr FRA,FW,Crystal Palace,23,1998,17.4,16,10,2,7,7,7,21,33.3,14,20,5,15,0,16,18,0,Matches
138,CJ Egan-Riley,eng ENG,DF,Manchester City,18,2003,0.0,1,1,1,0,0,1,1,100.0,0,0,0,0,0,1,0,0,Matches
139,Anthony Elanga,se SWE,FW,Manchester Utd,19,2002,13.5,26,20,12,12,2,15,29,51.7,14,17,1,16,9,35,7,0,Matches
140,Harvey Elliott,eng ENG,MF,Liverpool,18,2003,3.8,3,0,1,1,1,0,6,0.0,6,8,1,7,4,7,2,0,Matches
141,Mohamed Elneny,eg EGY,MF,Arsenal,29,1992,9.0,16,8,10,5,1,7,12,58.3,5,7,1,6,14,30,13,0,Matches
142,Mohamed Elyounoussi,no NOR,"MF,FW",Southampton,26,1994,22.7,36,17,14,15,7,11,39,28.2,28,23,2,21,12,48,28,0,Matches
143,Emerson,br BRA,"DF,MF",Tottenham,22,1999,25.4,72,47,50,16,6,36,67,53.7,31,25,2,23,22,94,92,1,Matches
144,Christian Eriksen,dk DEN,MF,Brentford,29,1992,10.4,13,6,4,5,4,8,17,47.1,9,9,1,8,9,22,14,0,Matches
145,Oghenekaro Etebo,ng NGA,MF,Watford,25,1995,4.5,11,8,7,4,0,3,8,37.5,5,3,1,2,5,16,5,0,Matches
146,Jonny Evans,nir NIR,DF,Leicester City,33,1988,15.0,24,14,14,8,2,14,22,63.6,8,17,13,4,20,44,59,0,Matches
147,Eberechi Eze,eng ENG,"MF,FW",Crystal Palace,23,1998,6.7,10,6,5,2,3,6,11,54.5,5,4,1,3,5,15,1,0,Matches
148,Łukasz Fabiański,pl POL,GK,West Ham,36,1985,37.0,0,0,0,0,0,0,0,,0,0,0,0,0,0,11,0,Matches
149,Fabinho,br BRA,MF,Liverpool,27,1993,25.7,46,25,17,23,6,24,70,34.3,46,33,10,23,39,85,25,1,Matches
150,Kiko Femenía,es ESP,DF,Watford,30,1991,23.8,35,22,23,10,2,21,37,56.8,16,24,8,16,37,72,51,0,Matches
151,Evan Ferguson,ie IRL,MF,Brighton,16,2004,0.3,0,0,0,0,0,0,0,,0,0,0,0,0,0,0,0,Matches
152,Nathan Ferguson,eng ENG,DF,Crystal Palace,20,2000,0.1,0,0,0,0,0,0,0,,0,0,0,0,0,0,0,0,Matches
153,Bruno Fernandes,pt POR,MF,Manchester Utd,26,1994,34.6,54,28,26,22,6,26,91,28.6,65,36,0,36,17,71,42,2,Matches
154,Álvaro Fernández,es ESP,GK,Brentford,23,1998,12.0,0,0,0,0,0,0,0,,0,0,0,0,0,0,5,2,Matches
155,Federico Fernández,ar ARG,DF,Newcastle Utd,32,1989,5.8,3,0,3,0,0,2,5,40.0,3,10,10,0,4,7,28,0,Matches
156,Fernandinho,br BRA,"MF,DF",Manchester City,36,1985,10.7,21,10,7,10,4,9,27,33.3,18,8,2,6,8,29,13,1,Matches
157,Roberto Firmino,br BRA,FW,Liverpool,29,1991,11.0,23,14,5,8,10,3,16,18.8,13,20,0,20,4,27,3,0,Matches
158,Junior Firpo,do DOM,"DF,MF",Leeds United,24,1996,19.0,61,29,30,26,5,31,59,52.5,28,22,6,16,24,85,37,0,Matches
159,Ashley Fletcher,eng ENG,FW,Watford,25,1995,0.3,2,1,1,1,0,1,1,100.0,0,1,1,0,0,2,0,0,Matches
160,Phil Foden,eng ENG,FW,Manchester City,21,2000,23.6,16,8,10,4,2,7,17,41.2,10,9,0,9,11,27,5,0,Matches
161,Wesley Fofana,fr FRA,DF,Leicester City,20,2000,7.0,12,8,11,1,0,7,11,63.6,4,5,2,3,12,24,26,1,Matches
162,Pablo Fornals,es ESP,"FW,MF",West Ham,25,1996,31.1,54,28,21,21,12,22,84,26.2,62,49,2,47,27,81,16,1,Matches
163,Adam Forshaw,eng ENG,MF,Leeds United,29,1991,17.0,53,23,21,27,5,21,54,38.9,33,17,1,16,19,72,12,2,Matches
164,Marcus Forss,fi FIN,"FW,MF",Brentford,22,1999,2.3,3,3,0,2,1,2,4,50.0,2,5,0,5,1,4,0,0,Matches
165,Fraser Forster,eng ENG,GK,Southampton,33,1988,19.0,1,0,1,0,0,0,1,0.0,1,0,0,0,0,1,23,2,Matches
166,Ben Foster,eng ENG,GK,Watford,38,1983,26.0,0,0,0,0,0,0,3,0.0,3,0,0,0,0,0,9,4,Matches
167,Tariqe Fosu,gh GHA,DF,Brentford,25,1995,0.2,0,0,0,0,0,0,0,,0,1,0,1,0,0,0,0,Matches
168,Ryan Fraser,sct SCO,"FW,MF",Newcastle Utd,27,1994,16.3,10,3,5,3,2,5,13,38.5,8,11,1,10,11,21,11,0,Matches
169,Fred,br BRA,MF,Manchester Utd,28,1993,22.5,63,27,32,24,7,22,79,27.8,57,38,11,27,32,95,24,0,Matches
170,Ryan Fredericks,eng ENG,DF,West Ham,28,1992,3.4,2,2,2,0,0,0,1,0.0,1,2,1,1,4,6,6,0,Matches
171,Leo Fuhr Hjelde,no NOR,"MF,DF",Leeds United,17,2003,1.7,5,4,3,2,0,3,3,100.0,0,3,3,0,4,9,7,0,Matches
172,Conor Gallagher,eng ENG,MF,Crystal Palace,21,2000,31.6,69,38,35,20,14,21,69,30.4,48,58,9,49,29,98,26,0,Matches
173,Alejandro Garnacho,ar ARG,"FW,MF",Manchester Utd,17,2004,0.1,0,0,0,0,0,0,1,0.0,1,0,0,0,0,0,0,0,Matches
174,Dwight Gayle,eng ENG,"FW,DF",Newcastle Utd,30,1990,0.4,1,0,0,1,0,0,1,0.0,1,0,0,0,1,2,0,0,Matches
175,Jean-Philippe Gbamin,ci CIV,MF,Everton,25,1995,0.7,1,1,1,0,0,0,2,0.0,2,0,0,0,1,2,1,0,Matches
176,David de Gea,es ESP,GK,Manchester Utd,30,1990,38.0,0,0,0,0,0,0,0,,0,0,0,0,0,0,11,2,Matches
177,Joe Gelhardt,eng ENG,"FW,MF",Leeds United,19,2002,8.3,4,3,1,0,3,2,10,20.0,8,9,0,9,0,4,3,0,Matches
178,Anwar El Ghazi,nl NED,"FW,MF",Aston Villa,26,1995,4.3,4,4,2,2,0,2,7,28.6,5,6,0,6,1,5,2,0,Matches
179,Anwar El Ghazi,nl NED,"FW,MF",Everton,26,1995,0.1,1,1,1,0,0,1,1,100.0,0,3,0,3,0,1,0,0,Matches
180,Saman Ghoddos,ir IRN,"MF,DF",Brentford,27,1993,6.0,17,10,8,6,3,9,15,60.0,6,2,0,2,3,20,16,0,Matches
181,Dimitris Giannoulis,gr GRE,DF,Norwich City,25,1995,13.0,36,21,17,17,2,24,36,66.7,12,22,6,16,19,55,41,1,Matches
182,Morgan Gibbs-White,eng ENG,"DF,FW",Wolves,21,2000,0.1,0,0,0,0,0,0,0,,0,1,0,1,0,0,0,0,Matches
183,Ben Gibson,eng ENG,DF,Norwich City,28,1993,27.7,23,16,17,6,0,7,12,58.3,5,36,30,6,27,50,139,2,Matches
184,Bryan Gil,es ESP,"FW,MF",Tottenham,20,2001,1.0,3,0,1,0,2,1,2,50.0,1,2,0,2,0,3,0,0,Matches
185,Billy Gilmour,sct SCO,MF,Norwich City,20,2001,20.6,41,21,16,21,4,14,52,26.9,38,21,4,17,17,58,29,0,Matches
186,Ben Godfrey,eng ENG,DF,Everton,23,1998,22.5,47,32,29,14,4,24,39,61.5,15,41,19,22,15,62,100,2,Matches
187,André Gomes,pt POR,MF,Everton,28,1993,6.9,16,4,6,6,4,8,32,25.0,24,8,2,6,1,17,7,1,Matches
188,Toti Gomes,pt POR,DF,Wolves,22,1999,4.0,11,7,10,1,0,7,9,77.8,2,6,3,3,8,19,15,0,Matches
189,Joe Gomez,eng ENG,DF,Liverpool,24,1997,3.7,10,6,5,2,3,5,9,55.6,4,4,1,3,5,15,6,0,Matches
190,Charlie Goode,eng ENG,DF,Brentford,25,1995,5.0,7,5,5,2,0,4,4,100.0,0,4,2,2,2,9,8,0,Matches
191,Anthony Gordon,eng ENG,"MF,FW",Everton,20,2001,25.4,54,32,20,30,4,21,59,35.6,38,49,3,46,22,76,17,0,Matches
192,Kaide Gordon,eng ENG,FW,Liverpool,16,2004,0.1,1,0,0,0,1,0,0,,0,0,0,0,0,1,0,0,Matches
193,Dan Gosling,eng ENG,MF,Watford,31,1990,1.8,2,1,1,1,0,2,6,33.3,4,2,0,2,0,2,3,0,Matches
194,Demarai Gray,jm JAM,"MF,FW",Everton,25,1996,26.0,30,19,13,10,7,10,22,45.5,12,30,2,28,15,45,21,1,Matches
195,Jack Grealish,eng ENG,FW,Manchester City,25,1995,21.3,18,17,4,10,4,5,13,38.5,8,11,1,10,8,26,7,0,Matches
196,Mason Greenwood,eng ENG,"FW,MF",Manchester Utd,19,2001,14.1,15,9,9,1,5,3,9,33.3,6,5,0,5,1,16,6,0,Matches
197,Sam Greenwood,eng ENG,"MF,FW",Leeds United,19,2002,2.6,8,5,0,5,3,4,7,57.1,3,3,0,3,2,10,1,0,Matches
198,Pascal Groß,de GER,"MF,DF",Brighton,30,1991,22.6,28,15,15,11,2,12,33,36.4,21,34,8,26,18,46,23,0,Matches
199,Vicente Guaita,es ESP,GK,Crystal Palace,34,1987,29.5,1,0,1,0,0,1,1,100.0,0,0,0,0,1,2,8,1,Matches
200,Marc Guéhi,eng ENG,DF,Crystal Palace,21,2000,35.8,35,17,24,10,1,15,16,93.8,1,34,26,8,30,65,127,0,Matches
201,Bruno Guimarães,br BRA,MF,Newcastle Utd,23,1997,11.5,44,23,18,22,4,21,38,55.3,17,25,6,19,9,53,13,0,Matches
202,İlkay Gündoğan,de GER,MF,Manchester City,30,1990,20.6,23,9,10,12,1,12,31,38.7,19,11,1,10,15,38,10,0,Matches
203,Angus Gunn,sct SCO,GK,Norwich City,25,1996,9.0,0,0,0,0,0,0,0,,0,0,0,0,0,0,11,0,Matches
204,Grant Hanley,sct SCO,DF,Norwich City,29,1991,32.2,44,25,28,14,2,18,35,51.4,17,56,45,11,56,100,176,2,Matches
205,Jack Harrison,eng ENG,"FW,MF",Leeds United,24,1996,29.3,57,37,22,22,13,31,76,40.8,45,35,1,34,21,78,19,0,Matches
206,Kortney Hause,eng ENG,DF,Aston Villa,26,1995,4.4,3,3,2,0,1,3,4,75.0,1,8,5,3,6,9,13,0,Matches
207,Kai Havertz,de GER,"FW,MF",Chelsea,22,1999,20.1,17,8,5,7,5,4,14,28.6,10,28,1,27,4,21,32,1,Matches
208,Isaac Hayden,eng ENG,"MF,DF",Newcastle Utd,26,1995,11.1,28,14,11,14,3,12,29,41.4,17,17,8,9,14,42,24,0,Matches
209,Hwang Hee-chan,kr KOR,"FW,MF",Wolves,25,1996,20.2,27,13,9,16,2,14,44,31.8,30,10,0,10,13,40,7,1,Matches
210,Jordan Henderson,eng ENG,MF,Liverpool,31,1990,28.9,36,20,9,25,2,17,44,38.6,27,25,1,24,23,59,14,0,Matches
211,Jeff Hendrick,ie IRL,MF,Newcastle Utd,29,1992,0.8,1,1,0,1,0,1,1,100.0,0,0,0,0,0,1,1,0,Matches
212,Wayne Hennessey,wls WAL,GK,Burnley,34,1987,2.0,0,0,0,0,0,0,0,,0,0,0,0,1,1,0,1,Matches
213,Rico Henry,eng ENG,DF,Brentford,24,1997,30.8,28,20,18,8,2,12,34,35.3,22,31,10,21,26,54,76,1,Matches
214,Son Heung-min,kr KOR,"MF,FW",Tottenham,29,1992,33.4,15,6,5,7,3,5,23,21.7,18,27,6,21,13,28,8,0,Matches
215,Ki-Jana Hoever,nl NED,"DF,MF",Wolves,19,2002,3.4,10,6,5,5,0,7,12,58.3,5,6,0,6,6,16,8,0,Matches
216,Rob Holding,eng ENG,DF,Arsenal,25,1995,9.4,13,9,11,1,1,5,6,83.3,1,23,18,5,10,23,42,1,Matches
217,Mason Holgate,eng ENG,DF,Everton,24,1996,23.7,35,18,26,9,0,11,26,42.3,15,25,17,8,26,61,95,1,Matches
218,Callum Hudson-Odoi,eng ENG,"MF,FW",Chelsea,20,2000,10.7,14,10,5,6,3,8,23,34.8,15,8,0,8,2,16,6,1,Matches
219,Will Hughes,eng ENG,MF,Crystal Palace,26,1995,11.7,29,14,10,16,3,7,16,43.8,9,13,7,6,8,37,10,0,Matches
220,Pierre Højbjerg,dk DEN,MF,Tottenham,25,1995,35.5,78,45,31,38,9,38,85,44.7,47,61,13,48,48,126,54,0,Matches
221,Adam Idah,ie IRL,"FW,MF",Norwich City,20,2001,6.9,9,6,2,5,2,2,3,66.7,1,4,2,2,3,12,7,0,Matches
222,Kelechi Iheanacho,ng NGA,FW,Leicester City,24,1996,14.0,10,7,2,5,3,3,14,21.4,11,19,0,19,4,14,10,0,Matches
223,Danny Ings,eng ENG,FW,Aston Villa,29,1992,21.1,23,16,2,16,5,13,37,35.1,24,31,2,29,6,29,22,0,Matches
224,Tim Iroegbunam,eng ENG,MF,Aston Villa,18,2003,1.0,5,4,2,3,0,1,1,100.0,0,0,0,0,2,7,1,0,Matches
225,Alex Iwobi,ng NGA,"MF,DF",Everton,25,1996,22.6,40,19,23,12,5,21,52,40.4,31,39,3,36,20,60,25,2,Matches
226,Daniel James,wls WAL,FW,Manchester Utd,23,1997,1.4,2,1,0,2,0,0,0,,0,2,0,2,0,2,1,0,Matches
227,Daniel James,wls WAL,"FW,MF",Leeds United,23,1997,26.3,24,14,8,8,8,10,23,43.5,13,18,1,17,8,32,12,0,Matches
228,Reece James,eng ENG,DF,Chelsea,21,1999,20.7,33,25,14,18,1,9,22,40.9,13,20,2,18,17,50,22,0,Matches
229,Vitaly Janelt,de GER,MF,Brentford,23,1998,25.5,61,32,26,27,8,27,53,50.9,26,23,7,16,28,89,35,0,Matches
230,Pontus Jansson,se SWE,DF,Brentford,30,1991,36.9,40,21,32,8,0,22,34,64.7,12,37,27,10,52,92,187,0,Matches
231,Mathias Jensen,dk DEN,MF,Brentford,25,1996,17.8,33,18,12,16,5,22,63,34.9,41,32,3,29,22,55,13,0,Matches
232,Gabriel Jesus,br BRA,FW,Manchester City,24,1997,20.9,18,12,2,4,12,6,26,23.1,20,18,0,18,15,33,8,0,Matches
233,Raúl Jiménez,mx MEX,FW,Wolves,30,1991,29.2,29,14,6,16,7,6,30,20.0,24,31,5,26,13,42,26,0,Matches
234,João Pedro,br BRA,"FW,MF",Watford,19,2001,18.3,20,14,7,8,5,6,23,26.1,17,23,3,20,15,35,17,0,Matches
235,Joelinton,br BRA,"MF,FW",Newcastle Utd,24,1996,28.4,72,38,30,33,9,26,61,42.6,35,46,11,35,34,106,50,2,Matches
236,Ben Johnson,eng ENG,DF,West Ham,21,2000,15.5,33,16,15,15,3,21,28,75.0,7,16,8,8,22,55,55,0,Matches
237,Curtis Jones,eng ENG,MF,Liverpool,20,2001,9.5,11,9,3,6,2,1,10,10.0,9,4,0,4,6,17,4,0,Matches
238,Phil Jones,eng ENG,DF,Manchester Utd,29,1992,1.8,5,5,3,1,1,2,3,66.7,1,4,4,0,3,8,8,0,Matches
239,Jorginho,it ITA,MF,Chelsea,29,1991,25.3,64,33,27,31,6,29,83,34.9,54,27,4,23,36,100,21,1,Matches
240,Diogo Jota,pt POR,FW,Liverpool,24,1996,26.3,39,18,12,18,9,13,55,23.6,42,19,2,17,6,45,6,0,Matches
241,James Justin,eng ENG,DF,Leicester City,23,1998,11.1,22,13,11,8,3,7,15,46.7,8,16,4,12,17,39,34,0,Matches
242,Mathias Jørgensen,dk DEN,DF,Brentford,31,1990,5.8,10,4,3,5,2,7,10,70.0,3,6,1,5,10,20,13,0,Matches
243,Ozan Kabak,tr TUR,DF,Norwich City,21,2000,10.2,10,5,4,6,0,5,9,55.6,4,19,11,8,16,26,26,0,Matches
244,Christian Kabasele,be BEL,DF,Watford,30,1991,13.3,11,5,10,1,0,7,10,70.0,3,20,16,4,14,25,67,1,Matches
245,Samuel Kalu,ng NGA,FW,Watford,23,1997,2.5,2,2,0,2,0,1,1,100.0,0,2,0,2,3,5,3,0,Matches
246,Hassane Kamara,ci CIV,DF,Watford,27,1994,18.0,53,34,31,16,6,27,43,62.8,16,20,4,16,69,122,67,0,Matches
247,Harry Kane,eng ENG,FW,Tottenham,28,1993,35.9,15,5,2,10,3,7,18,38.9,11,26,8,18,3,18,39,0,Matches
248,N'Golo Kanté,fr FRA,MF,Chelsea,30,1991,19.7,59,31,20,27,12,25,40,62.5,15,37,2,35,31,90,8,0,Matches
249,Edo Kayembe,cd COD,MF,Watford,23,1998,8.9,21,13,11,9,1,8,16,50.0,8,6,1,5,9,30,13,0,Matches
250,Moise Kean,it ITA,FW,Everton,21,2000,0.0,0,0,0,0,0,0,0,,0,0,0,0,0,0,0,0,Matches
251,Michael Keane,eng ENG,DF,Everton,28,1993,31.0,46,25,32,13,1,28,45,62.2,17,33,28,5,62,108,128,2,Matches
252,Naby Keïta,gn GUI,MF,Liverpool,26,1995,13.0,46,23,17,19,10,26,42,61.9,16,33,2,31,14,60,8,0,Matches
253,Caoimhín Kelleher,ie IRL,GK,Liverpool,22,1998,2.0,1,1,1,0,0,1,1,100.0,0,0,0,0,0,1,1,0,Matches
254,Kenedy,br BRA,DF,Chelsea,25,1996,0.6,5,2,1,2,2,2,3,66.7,1,0,0,0,0,5,0,0,Matches
255,Jonjoe Kenny,eng ENG,DF,Everton,24,1997,11.3,17,7,11,6,0,13,21,61.9,8,8,1,7,20,37,31,0,Matches
256,Max Kilman,eng ENG,DF,Wolves,24,1997,29.9,50,26,38,10,2,24,37,64.9,13,36,21,15,45,95,113,3,Matches
257,Joshua King,no NOR,FW,Watford,29,1992,25.0,19,15,7,6,6,4,17,23.5,13,15,4,11,8,27,31,0,Matches
258,Kristoffer Klaesson,no NOR,GK,Leeds United,20,2000,0.4,0,0,0,0,0,0,0,,0,0,0,0,0,0,0,0,Matches
259,Mateusz Klich,pl POL,MF,Leeds United,31,1990,23.0,47,25,18,23,6,25,66,37.9,41,22,4,18,11,58,20,0,Matches
260,Robin Koch,de GER,"MF,DF",Leeds United,25,1996,17.5,21,13,9,10,2,9,34,26.5,25,26,10,16,20,41,44,0,Matches
261,Sead Kolašinac,ba BIH,DF,Arsenal,28,1993,1.0,0,0,0,0,0,0,0,,0,0,0,0,4,4,1,0,Matches
262,Ibrahima Konaté,fr FRA,DF,Liverpool,22,1999,11.0,16,10,9,6,1,7,10,70.0,3,13,9,4,16,32,37,1,Matches
263,Ezri Konsa,eng ENG,DF,Aston Villa,23,1997,27.5,25,15,13,11,1,10,13,76.9,3,31,22,9,15,40,86,2,Matches
264,Cheikhou Kouyaté,sn SEN,MF,Crystal Palace,31,1989,21.9,52,38,28,22,2,18,39,46.2,21,40,14,26,38,90,39,0,Matches
265,Mateo Kovačić,hr CRO,MF,Chelsea,27,1994,17.3,51,31,14,26,11,17,35,48.6,18,19,4,15,7,58,9,1,Matches
266,Emil Krafth,se SWE,DF,Newcastle Utd,26,1994,18.2,37,16,25,11,1,27,36,75.0,9,16,10,6,25,62,56,0,Matches
267,Alex Král,cz CZE,MF,West Ham,23,1998,0.0,0,0,0,0,0,0,0,,0,0,0,0,0,0,0,0,Matches
268,Tim Krul,nl NED,GK,Norwich City,33,1988,29.0,1,1,1,0,0,1,4,25.0,3,0,0,0,0,1,10,4,Matches
269,Juraj Kucka,sk SVK,MF,Watford,34,1987,21.3,59,39,32,25,2,27,73,37.0,46,30,9,21,27,86,46,2,Matches
270,Dejan Kulusevski,se SWE,"MF,FW",Tottenham,21,2000,14.0,19,13,7,10,2,5,23,21.7,18,14,0,14,13,32,3,0,Matches
271,Alexandre Lacazette,fr FRA,FW,Arsenal,30,1991,19.8,27,10,8,13,6,7,21,33.3,14,12,1,11,5,32,6,0,Matches
272,Adam Lallana,eng ENG,MF,Brighton,33,1988,17.3,34,17,14,14,6,12,41,29.3,29,16,6,10,16,50,13,1,Matches
273,Tariq Lamptey,gh GHA,"DF,FW",Brighton,20,2000,17.3,36,25,14,17,5,15,25,60.0,10,13,3,10,21,57,23,0,Matches
274,Manuel Lanzini,ar ARG,"MF,FW",West Ham,28,1993,19.8,28,15,10,11,7,10,35,28.6,25,16,0,16,19,47,10,0,Matches
275,Aymeric Laporte,es ESP,DF,Manchester City,27,1994,31.4,33,15,22,10,1,14,20,70.0,6,15,10,5,20,53,64,2,Matches
276,Jamaal Lascelles,eng ENG,DF,Newcastle Utd,27,1993,22.9,15,7,9,5,1,4,12,33.3,8,38,28,10,22,37,121,1,Matches
277,Pierre Lees-Melou,fr FRA,MF,Norwich City,28,1993,25.2,58,36,23,29,6,25,92,27.2,67,37,11,26,25,83,23,0,Matches
278,Aaron Lennon,eng ENG,"MF,FW",Burnley,34,1987,17.2,33,17,10,13,10,10,34,29.4,24,26,4,22,9,42,14,0,Matches
279,Bernd Leno,de GER,GK,Arsenal,29,1992,4.0,1,1,1,0,0,1,1,100.0,0,0,0,0,0,1,1,0,Matches
280,Jamal Lewis,nir NIR,DF,Newcastle Utd,23,1998,2.9,8,6,6,1,1,3,4,75.0,1,3,2,1,3,11,8,0,Matches
281,Victor Lindelöf,se SWE,DF,Manchester Utd,27,1994,26.2,16,11,9,7,0,9,14,64.3,5,26,17,9,25,41,96,0,Matches
282,Jesse Lingard,eng ENG,"FW,MF",Manchester Utd,28,1992,4.1,9,7,4,3,2,2,6,33.3,4,4,0,4,0,9,1,0,Matches
283,Valentino Livramento,eng ENG,DF,Southampton,18,2002,24.5,54,28,30,18,6,27,45,60.0,18,23,9,14,47,101,50,1,Matches
284,Diego Llorente,es ESP,DF,Leeds United,27,1993,26.0,53,31,32,19,2,33,47,70.2,14,35,17,18,40,93,77,2,Matches
285,Hugo Lloris,fr FRA,GK,Tottenham,34,1986,38.0,1,1,1,0,0,1,2,50.0,1,0,0,0,1,2,24,3,Matches
286,Giovani Lo Celso,ar ARG,"MF,FW",Tottenham,25,1996,2.6,8,4,4,2,2,4,10,40.0,6,6,1,5,1,9,0,1,Matches
287,Jürgen Locadia,cw CUW,"MF,FW",Brighton,27,1993,0.3,0,0,0,0,0,0,0,,0,0,0,0,0,0,0,0,Matches
288,Ruben Loftus-Cheek,eng ENG,"MF,DF",Chelsea,25,1996,15.5,29,10,16,11,2,10,19,52.6,9,15,6,9,11,40,17,0,Matches
289,Kevin Long,ie IRL,DF,Burnley,30,1990,4.6,3,2,1,2,0,1,2,50.0,1,4,1,3,1,4,20,0,Matches
290,Shane Long,ie IRL,FW,Southampton,34,1987,3.4,9,5,2,4,3,1,1,100.0,0,4,0,4,0,9,2,0,Matches
291,Sean Longstaff,eng ENG,MF,Newcastle Utd,23,1997,16.3,54,34,18,31,5,24,65,36.9,41,18,6,12,9,63,18,0,Matches
292,Ademola Lookman,ng NGA,"FW,MF",Leicester City,23,1997,16.1,32,14,10,13,9,10,28,35.7,18,19,1,18,10,42,4,0,Matches
293,Jonas Lössl,dk DEN,GK,Brentford,32,1989,2.0,0,0,0,0,0,0,0,,0,0,0,0,0,0,1,0,Matches
294,Imran Louza,ma MAR,MF,Watford,22,1999,15.7,41,21,18,20,3,16,38,42.1,22,28,6,22,42,83,20,1,Matches
295,Matthew Lowton,eng ENG,DF,Burnley,32,1989,19.7,38,24,20,10,8,20,37,54.1,17,25,11,14,26,64,68,0,Matches
296,Douglas Luiz,br BRA,MF,Aston Villa,23,1998,30.2,59,39,30,24,5,21,72,29.2,51,30,7,23,34,93,28,1,Matches
297,Romelu Lukaku,be BEL,FW,Chelsea,28,1993,17.7,2,1,0,1,1,1,5,20.0,4,11,1,10,0,2,20,0,Matches
298,Lyanco,br BRA,DF,Southampton,24,1997,10.1,18,15,11,7,0,10,18,55.6,8,18,13,5,13,31,50,1,Matches
299,Alexis Mac Allister,ar ARG,"MF,FW",Brighton,22,1998,23.6,65,40,23,30,12,29,68,42.6,39,37,7,30,13,78,22,0,Matches
300,James Maddison,eng ENG,"MF,FW",Leicester City,24,1996,27.3,40,20,8,24,8,14,46,30.4,32,18,3,15,11,51,12,0,Matches
301,Gabriel Magalhães,br BRA,DF,Arsenal,23,1997,34.0,50,30,36,12,2,30,41,73.2,11,34,26,8,13,63,112,4,Matches
302,Harry Maguire,eng ENG,DF,Manchester Utd,28,1993,27.9,34,21,22,8,4,19,31,61.3,12,36,29,7,32,66,101,3,Matches
303,Riyad Mahrez,dz ALG,FW,Manchester City,30,1991,16.6,11,3,5,4,2,5,19,26.3,14,15,1,14,6,17,6,0,Matches
304,Ainsley Maitland-Niles,eng ENG,MF,Arsenal,23,1997,3.0,8,4,5,3,0,2,4,50.0,2,2,0,2,4,12,4,0,Matches
305,Sadio Mané,sn SEN,FW,Liverpool,29,1992,31.3,33,20,7,14,12,8,26,30.8,18,30,1,29,8,41,15,0,Matches
306,Javier Manquillo,es ESP,DF,Newcastle Utd,27,1994,14.0,39,29,28,10,1,21,36,58.3,15,15,6,9,10,49,32,0,Matches
307,Fernando Marçal,br BRA,"MF,DF",Wolves,32,1989,16.1,42,22,27,14,1,21,37,56.8,16,25,4,21,28,70,52,0,Matches
308,Solly March,eng ENG,"DF,FW",Brighton,27,1994,19.4,30,17,11,9,10,7,22,31.8,15,22,3,19,17,47,25,0,Matches
309,Pablo Marí,es ESP,DF,Arsenal,27,1993,2.0,5,3,1,3,1,3,6,50.0,3,5,4,1,3,8,10,0,Matches
310,Anthony Martial,fr FRA,FW,Manchester Utd,25,1995,2.4,0,0,0,0,0,0,1,0.0,1,1,0,1,0,0,1,0,Matches
311,Gabriel Martinelli,br BRA,"FW,MF",Arsenal,20,2001,20.7,27,19,7,14,6,10,29,34.5,19,26,1,25,20,47,15,0,Matches
312,Emiliano Martínez,ar ARG,GK,Aston Villa,28,1992,36.0,1,1,1,0,0,1,3,33.3,2,0,0,0,0,1,6,1,Matches
313,Adam Masina,ma MAR,DF,Watford,27,1994,12.0,24,13,11,10,3,12,29,41.4,17,18,6,12,18,42,45,0,Matches
314,Arthur Masuaku,cd COD,"DF,FW",West Ham,27,1993,7.2,31,23,19,11,1,14,23,60.9,9,9,1,8,9,40,17,0,Matches
315,Juan Mata,es ESP,MF,Manchester Utd,33,1988,2.6,6,4,2,3,1,3,5,60.0,2,1,0,1,1,7,1,0,Matches
316,Jean-Philippe Mateta,fr FRA,FW,Crystal Palace,24,1997,12.7,8,4,2,5,1,3,18,16.7,15,11,3,8,4,12,13,0,Matches
317,Nemanja Matić,rs SRB,MF,Manchester Utd,32,1988,15.4,31,18,19,11,1,15,31,48.4,16,21,6,15,31,62,21,3,Matches
318,Joël Matip,cm CMR,DF,Liverpool,29,1991,31.0,47,34,23,19,5,20,31,64.5,11,26,14,12,44,91,93,1,Matches
319,Neal Maupay,fr FRA,FW,Brighton,24,1996,25.3,17,10,2,6,9,4,18,22.2,14,21,2,19,2,19,2,0,Matches
320,Bryan Mbeumo,cm CMR,FW,Brentford,21,1999,32.3,28,16,1,12,15,6,20,30.0,14,21,6,15,11,39,20,0,Matches
321,James McArthur,sct SCO,MF,Crystal Palace,33,1987,16.0,33,23,13,19,1,16,44,36.4,28,23,9,14,30,63,27,0,Matches
322,James Mcatee,eng ENG,"MF,FW",Manchester City,18,2002,0.2,0,0,0,0,0,0,2,0.0,2,0,0,0,0,0,0,0,Matches
323,Kasey McAteer,ie IRL,FW,Leicester City,19,2001,0.0,0,0,0,0,0,0,0,,0,0,0,0,0,0,0,0,Matches
324,Liam McCarron,sct SCO,FW,Leeds United,20,2001,0.1,0,0,0,0,0,0,0,,0,1,0,1,0,0,0,0,Matches
325,Alex McCarthy,eng ENG,GK,Southampton,31,1989,17.0,0,0,0,0,0,0,0,,0,0,0,0,0,0,4,0,Matches
326,John McGinn,sct SCO,MF,Aston Villa,26,1994,34.3,106,64,35,55,16,54,104,51.9,50,53,6,47,35,141,34,0,Matches
327,Stuart McKinstry,sct SCO,MF,Leeds United,18,2002,0.0,0,0,0,0,0,0,0,,0,0,0,0,0,0,0,0,Matches
328,Kenny McLean,sct SCO,MF,Norwich City,29,1992,30.1,42,22,18,20,4,17,59,28.8,42,29,7,22,34,76,54,0,Matches
329,Dwight McNeil,eng ENG,MF,Burnley,21,1999,34.5,78,49,27,38,13,33,73,45.2,40,64,11,53,35,113,31,1,Matches
330,Scott McTominay,sct SCO,MF,Manchester Utd,24,1996,26.5,65,33,32,24,9,30,61,49.2,31,45,10,35,31,96,60,1,Matches
331,Ben Mee,eng ENG,DF,Burnley,31,1989,20.4,26,12,16,7,3,12,19,63.2,7,28,22,6,24,50,94,1,Matches
332,Hannibal Mejbri,tn TUN,FW,Manchester Utd,18,2003,0.8,2,1,1,1,0,1,1,100.0,0,0,0,0,0,2,0,0,Matches
333,Benjamin Mendy,fr FRA,DF,Manchester City,27,1994,0.9,2,2,1,1,0,2,6,33.3,4,0,0,0,0,2,0,0,Matches
334,Edouard Mendy,sn SEN,GK,Chelsea,29,1992,34.0,1,0,1,0,0,1,3,33.3,2,0,0,0,0,1,13,4,Matches
335,Nampalys Mendy,sn SEN,MF,Leicester City,29,1992,11.5,12,6,8,4,0,6,17,35.3,11,7,4,3,11,23,11,1,Matches
336,Illan Meslier,fr FRA,GK,Leeds United,21,2000,37.6,1,1,1,0,0,1,1,100.0,0,0,0,0,0,1,27,1,Matches
337,Luka Milivojević,rs SRB,MF,Crystal Palace,30,1991,8.6,18,9,9,6,3,10,16,62.5,6,6,1,5,11,29,15,0,Matches
338,James Milner,eng ENG,"MF,DF",Liverpool,35,1986,9.5,28,16,12,11,5,12,29,41.4,17,19,5,14,17,45,20,0,Matches
339,Yerry Mina,co COL,DF,Everton,26,1994,9.4,12,10,12,0,0,10,13,76.9,3,13,9,4,11,23,38,1,Matches
340,Takumi Minamino,jp JPN,"FW,MF",Liverpool,26,1995,2.1,3,2,1,1,1,2,8,25.0,6,2,0,2,1,4,2,0,Matches
341,Tyrone Mings,eng ENG,DF,Aston Villa,28,1993,35.4,23,12,17,3,3,14,22,63.6,8,47,30,17,46,69,153,2,Matches
342,Tyrick Mitchell,eng ENG,DF,Crystal Palace,21,1999,34.5,104,57,67,26,11,46,67,68.7,21,47,5,42,41,145,101,0,Matches
343,Jakub Moder,pl POL,MF,Brighton,22,1999,18.9,42,25,18,17,7,23,42,54.8,19,25,2,23,10,52,22,1,Matches
344,Wesley Moraes,br BRA,FW,Aston Villa,24,1996,0.0,0,0,0,0,0,0,0,,0,0,0,0,0,0,0,0,Matches
345,Tyler Morton,eng ENG,MF,Liverpool,18,2002,0.7,0,0,0,0,0,0,2,0.0,2,0,0,0,3,3,0,0,Matches
346,Mason Mount,eng ENG,MF,Chelsea,22,1999,26.3,41,16,10,17,14,10,34,29.4,24,18,1,17,13,54,12,0,Matches
347,Lucas Moura,br BRA,"FW,MF",Tottenham,28,1992,19.7,25,10,7,14,4,8,35,22.9,27,19,0,19,18,43,19,0,Matches
348,João Moutinho,pt POR,MF,Wolves,34,1986,33.0,74,39,34,27,13,30,106,28.3,76,48,8,40,34,108,36,2,Matches
349,Bali Mumba,eng ENG,DF,Norwich City,19,2001,0.5,1,1,1,0,0,0,0,,0,0,0,0,0,1,5,0,Matches
350,Jacob Murphy,eng ENG,"FW,DF",Newcastle Utd,26,1995,16.4,49,26,34,11,4,26,41,63.4,15,20,2,18,23,72,17,0,Matches
351,Enock Mwepu,zm ZAM,MF,Brighton,23,1998,11.1,22,12,10,10,2,5,27,18.5,22,20,2,18,12,34,19,0,Matches
352,Vitaliy Mykolenko,ua UKR,DF,Everton,22,1999,11.7,25,15,15,7,3,12,21,57.1,9,15,2,13,16,41,37,0,Matches
353,Marvelous Nakamba,zw ZIM,MF,Aston Villa,27,1994,10.0,32,19,18,14,0,12,34,35.3,22,14,4,10,12,44,17,1,Matches
354,Wilfred Ndidi,ng NGA,"MF,DF",Leicester City,24,1996,18.0,60,32,32,27,1,22,55,40.0,33,36,8,28,42,102,54,1,Matches
355,Tanguy Ndombele,fr FRA,MF,Tottenham,24,1996,5.4,10,7,3,5,2,1,8,12.5,7,5,0,5,1,11,1,0,Matches
356,Reiss Nelson,eng ENG,FW,Arsenal,21,1999,0.2,1,0,0,0,1,0,1,0.0,1,1,0,1,0,1,0,0,Matches
357,Pedro Neto,pt POR,"FW,MF",Wolves,21,2000,5.2,4,4,2,0,2,0,9,0.0,9,0,0,0,6,10,1,0,Matches
358,Rúben Neves,pt POR,MF,Wolves,24,1997,29.6,68,37,23,41,4,24,87,27.6,63,39,5,34,41,109,49,3,Matches
359,Jeremy Ngakia,eng ENG,DF,Watford,20,2000,10.0,31,18,23,5,3,11,26,42.3,15,11,4,7,12,43,32,0,Matches
360,Saúl Ñíguez,es ESP,"DF,MF",Chelsea,26,1994,5.3,20,9,11,9,0,9,16,56.3,7,14,3,11,7,27,10,1,Matches
361,Eddie Nketiah,eng ENG,FW,Arsenal,22,1999,9.3,9,4,1,4,4,1,4,25.0,3,9,2,7,4,13,5,0,Matches
362,Nicolas Nkoulou,cm CMR,DF,Watford,31,1990,1.9,1,0,0,1,0,0,0,,0,2,1,1,2,3,8,0,Matches
363,Mark Noble,eng ENG,MF,West Ham,34,1987,3.7,8,2,7,1,0,5,11,45.5,6,4,1,3,4,12,2,1,Matches
364,Mathias Normann,no NOR,MF,Norwich City,25,1996,18.3,34,21,19,14,1,17,46,37.0,29,17,8,9,19,53,43,1,Matches
365,Christian Nørgaard,dk DEN,MF,Brentford,27,1994,33.9,109,60,42,58,9,52,101,51.5,49,48,9,39,64,173,58,1,Matches
366,Angelo Ogbonna,it ITA,DF,West Ham,33,1988,10.2,7,4,5,2,0,3,7,42.9,4,5,4,1,11,18,29,0,Matches
367,Michael Olise,fr FRA,"FW,MF",Crystal Palace,19,2001,12.7,22,18,8,11,3,7,24,29.2,17,17,0,17,6,28,6,0,Matches
368,Robin Olsen,se SWE,GK,Aston Villa,31,1990,1.0,0,0,0,0,0,0,0,,0,0,0,0,0,0,0,0,Matches
369,Andrew Omobamidele,ie IRL,DF,Norwich City,19,2002,4.2,8,6,5,3,0,5,11,45.5,6,8,8,0,5,13,13,0,Matches
370,Tyler Onyango,eng ENG,MF,Everton,18,2003,0.3,0,0,0,0,0,0,0,,0,0,0,0,0,0,1,0,Matches
371,Frank Onyeka,ng NGA,MF,Brentford,23,1998,11.6,25,17,13,9,3,8,27,29.6,19,16,2,14,14,39,13,0,Matches
372,Divock Origi,be BEL,FW,Liverpool,26,1995,1.5,0,0,0,0,0,0,2,0.0,2,1,0,1,1,1,2,0,Matches
373,Alex Oxlade-Chamberlain,eng ENG,"MF,FW",Liverpool,27,1993,8.7,15,11,2,8,5,3,14,21.4,11,12,2,10,6,21,5,0,Matches
374,Cole Palmer,eng ENG,"FW,MF",Manchester City,19,2002,1.4,2,1,1,1,0,0,2,0.0,2,3,0,3,1,3,0,0,Matches
375,Emerson Palmieri,it ITA,DF,Chelsea,26,1994,0.1,0,0,0,0,0,0,0,,0,0,0,0,0,0,0,0,Matches
376,Thomas Partey,gh GHA,MF,Arsenal,28,1993,22.5,43,29,22,17,4,18,44,40.9,26,22,4,18,23,66,35,2,Matches
377,Nicolas Pépé,ci CIV,"FW,MF",Arsenal,26,1995,7.7,8,5,3,5,0,3,9,33.3,6,9,1,8,8,16,2,0,Matches
378,Ricardo Pereira,pt POR,DF,Leicester City,27,1993,11.0,37,20,19,13,5,21,40,52.5,19,13,1,12,17,54,39,0,Matches
379,Ayoze Pérez,es ESP,"MF,FW",Leicester City,28,1993,4.9,4,2,0,3,1,0,13,0.0,13,11,1,10,2,6,5,0,Matches
380,Sonny Perkins,eng ENG,MF,West Ham,17,2004,0.0,0,0,0,0,0,0,0,,0,0,0,0,0,0,0,0,Matches
381,Romain Perraud,fr FRA,DF,Southampton,23,1997,18.0,34,22,18,14,2,16,29,55.2,13,24,6,18,17,51,42,0,Matches
382,Kalvin Phillips,eng ENG,MF,Leeds United,25,1995,17.7,54,25,24,25,5,24,57,42.1,33,37,9,28,24,78,18,0,Matches
383,Jaden Philogene Bidace,eng ENG,FW,Aston Villa,19,2002,0.1,0,0,0,0,0,0,0,,0,0,0,0,0,0,0,0,Matches
384,Jordan Pickford,eng ENG,GK,Everton,27,1994,35.0,1,1,1,0,0,0,1,0.0,1,1,0,1,1,2,14,1,Matches
385,Erik Pieters,nl NED,DF,Burnley,32,1988,8.1,28,15,15,11,2,17,28,60.7,11,18,7,11,10,38,38,0,Matches
386,Ethan Pinnock,jm JAM,DF,Brentford,28,1993,29.9,51,35,37,12,2,25,38,65.8,13,30,11,19,44,95,154,1,Matches
387,Daniel Podence,pt POR,"FW,MF",Wolves,25,1995,16.5,18,11,10,5,3,4,17,23.5,13,8,1,7,10,28,1,0,Matches
388,Paul Pogba,fr FRA,"MF,FW",Manchester Utd,28,1993,15.0,13,9,5,7,1,6,28,21.4,22,11,0,11,13,26,16,0,Matches
389,Nick Pope,eng ENG,GK,Burnley,29,1992,36.0,0,0,0,0,0,0,2,0.0,2,0,0,0,2,2,30,3,Matches
390,Isaac Price,nir NIR,MF,Everton,17,2003,0.2,0,0,0,0,0,0,0,,0,1,0,1,0,0,0,0,Matches
391,Teemu Pukki,fi FIN,FW,Norwich City,31,1990,36.1,23,11,2,14,7,6,29,20.7,23,21,1,20,4,27,3,0,Matches
392,Christian Pulisic,us USA,"MF,FW",Chelsea,22,1998,14.3,10,7,6,3,1,3,17,17.6,14,12,0,12,5,15,10,0,Matches
393,Przemysław Płacheta,pl POL,"FW,MF",Norwich City,23,1998,5.6,4,3,3,1,0,2,7,28.6,5,3,1,2,2,6,5,1,Matches
394,Jesurun Rak Sakyi,eng ENG,"FW,MF",Crystal Palace,18,2002,0.9,0,0,0,0,0,0,1,0.0,1,3,0,3,1,1,0,0,Matches
395,Aaron Ramsdale,eng ENG,GK,Arsenal,23,1998,34.0,2,1,2,0,0,1,2,50.0,1,0,0,0,0,2,26,3,Matches
396,Jacob Ramsey,eng ENG,MF,Aston Villa,20,2001,27.4,67,44,31,28,8,30,69,43.5,39,36,7,29,24,91,28,0,Matches
397,Raphinha,br BRA,"FW,MF",Leeds United,24,1996,32.4,51,29,25,14,12,22,71,31.0,49,43,0,43,29,80,28,1,Matches
398,Marcus Rashford,eng ENG,"FW,MF",Manchester Utd,23,1997,13.7,6,5,1,4,1,2,13,15.4,11,10,1,9,5,11,5,1,Matches
399,Milot Rashica,xk KVX,"FW,MF",Norwich City,25,1996,24.8,31,19,12,12,7,11,30,36.7,19,22,3,19,15,46,23,0,Matches
400,David Raya,es ESP,GK,Brentford,25,1995,24.0,0,0,0,0,0,0,0,,0,1,0,1,0,0,10,1,Matches
401,Nathan Redmond,eng ENG,"MF,FW",Southampton,27,1994,20.4,22,14,9,9,4,7,30,23.3,23,21,2,19,8,30,16,0,Matches
402,Sergio Reguilón,es ESP,"DF,MF",Tottenham,24,1996,21.3,40,24,15,18,7,22,43,51.2,21,20,8,12,31,71,45,1,Matches
403,Declan Rice,eng ENG,MF,West Ham,22,1999,35.3,80,42,45,32,3,38,71,53.5,33,45,21,24,63,143,52,1,Matches
404,Taylor Richards,eng ENG,MF,Brighton,20,2000,0.3,1,0,0,1,0,1,2,50.0,1,0,0,0,0,1,0,0,Matches
405,Richarlison,br BRA,FW,Everton,24,1997,28.0,40,23,18,15,7,15,31,48.4,16,42,4,38,12,52,34,0,Matches
406,Jaïro Riedewald,nl NED,MF,Crystal Palace,24,1996,1.3,1,1,0,1,0,1,2,50.0,1,1,0,1,1,2,2,0,Matches
407,Matt Ritchie,sct SCO,DF,Newcastle Utd,31,1989,14.9,22,15,10,10,2,10,27,37.0,17,10,2,8,13,35,26,0,Matches
408,Connor Roberts,wls WAL,DF,Burnley,25,1995,18.8,20,13,10,7,3,10,15,66.7,5,25,5,20,22,42,62,1,Matches
409,Tyler Roberts,wls WAL,"MF,FW",Leeds United,22,1999,11.0,16,7,6,7,3,9,16,56.3,7,11,1,10,5,21,11,0,Matches
410,Andrew Robertson,sct SCO,DF,Liverpool,27,1994,28.2,36,21,16,15,5,20,35,57.1,15,24,3,21,23,59,61,0,Matches
411,Joe Rodon,wls WAL,DF,Tottenham,23,1997,1.0,0,0,0,0,0,0,0,,0,2,1,1,0,0,7,0,Matches
412,Rodri,es ESP,MF,Manchester City,25,1996,32.0,72,43,24,38,10,32,59,54.2,27,28,5,23,28,100,45,0,Matches
413,Rodrigo,es ESP,"MF,FW",Leeds United,30,1991,25.2,20,9,7,6,7,4,32,12.5,28,12,0,12,11,31,27,1,Matches
414,Jay Rodriguez,eng ENG,FW,Burnley,32,1989,15.4,20,12,8,8,4,4,14,28.6,10,19,1,18,4,24,12,0,Matches
415,Mads Roerslev,dk DEN,DF,Brentford,22,1999,13.8,23,12,19,2,2,14,32,43.8,18,14,5,9,16,39,29,0,Matches
416,Cristian Romero,ar ARG,DF,Tottenham,23,1998,20.5,62,39,39,21,2,22,34,64.7,12,46,21,25,33,95,74,1,Matches
417,Oriol Romeu,es ESP,MF,Southampton,29,1991,32.1,77,39,25,45,7,28,73,38.4,45,39,8,31,51,128,43,0,Matches
418,Cristiano Ronaldo,pt POR,FW,Manchester Utd,36,1985,27.3,8,6,1,5,2,2,6,33.3,4,8,0,8,2,10,29,0,Matches
419,Salomón Rondón,ve VEN,FW,Everton,31,1989,8.8,6,1,1,2,3,4,14,28.6,10,5,0,5,0,6,10,0,Matches
420,Danny Rose,eng ENG,DF,Watford,31,1990,7.7,16,10,11,4,1,10,24,41.7,14,8,5,3,14,30,11,1,Matches
421,Jon Rowe,eng ENG,"FW,MF",Norwich City,18,2003,2.5,3,2,2,1,0,2,3,66.7,1,7,0,7,3,6,1,0,Matches
422,John Ruddy,eng ENG,GK,Wolves,34,1986,1.5,0,0,0,0,0,0,0,,0,0,0,0,0,0,3,0,Matches
423,Antonio Rüdiger,de GER,DF,Chelsea,28,1993,33.7,48,28,29,15,4,36,48,75.0,12,20,11,9,28,76,91,1,Matches
424,Lukas Rupp,de GER,MF,Norwich City,30,1991,8.5,9,4,5,3,1,4,15,26.7,11,11,1,10,9,18,7,0,Matches
425,José Sá,pt POR,GK,Wolves,28,1993,36.5,2,1,2,0,0,2,4,50.0,2,0,0,0,2,4,19,5,Matches
426,Allan Saint-Maximin,fr FRA,"FW,MF",Newcastle Utd,24,1997,31.2,13,8,6,4,3,3,17,17.6,14,13,2,11,11,24,3,0,Matches
427,Romain Saïss,ma MAR,DF,Wolves,31,1990,30.1,40,27,28,11,1,19,33,57.6,14,41,21,20,58,98,158,2,Matches
428,Bukayo Saka,eng ENG,"FW,MF",Arsenal,19,2001,33.1,40,21,12,17,11,13,39,33.3,26,28,2,26,22,62,23,0,Matches
429,Mohamed Salah,eg EGY,FW,Liverpool,29,1992,30.7,17,8,5,9,3,6,19,31.6,13,7,1,6,6,23,5,0,Matches
430,Mohammed Salisu,gh GHA,DF,Southampton,22,1999,33.0,80,47,54,22,4,40,65,61.5,25,49,26,23,78,158,158,4,Matches
431,Albert Sambi Lokonga,be BEL,MF,Arsenal,21,1999,12.6,22,18,11,9,2,12,14,85.7,2,12,7,5,13,35,12,4,Matches
432,Davinson Sánchez,co COL,DF,Tottenham,25,1996,18.1,41,22,25,14,2,19,28,67.9,9,24,16,8,30,71,54,3,Matches
433,Robert Sánchez,es ESP,GK,Brighton,23,1997,37.0,2,1,2,0,0,1,1,100.0,0,1,0,1,0,2,11,4,Matches
434,Jadon Sancho,eng ENG,"FW,MF",Manchester Utd,21,2000,21.1,14,8,9,4,1,8,22,36.4,14,19,0,19,15,29,5,3,Matches
435,Morgan Sanson,fr FRA,MF,Aston Villa,26,1994,4.0,12,8,7,2,3,3,7,42.9,4,13,0,13,10,22,2,1,Matches
436,Samir Santos,br BRA,DF,Watford,26,1994,18.6,24,11,18,6,0,8,19,42.1,11,21,11,10,43,67,85,3,Matches
437,Josh Sargent,us USA,"FW,MF",Norwich City,21,2000,17.5,26,14,15,7,4,14,39,35.9,25,29,2,27,11,37,18,2,Matches
438,Jeremy Sarmiento,ec ECU,"FW,MF",Brighton,19,2002,0.5,1,1,0,0,1,0,2,0.0,2,2,0,2,0,1,0,0,Matches
439,Ismaila Sarr,sn SEN,"FW,MF",Watford,23,1998,20.7,12,7,4,3,5,5,19,26.3,14,10,1,9,9,21,10,0,Matches
440,Malang Sarr,fr FRA,DF,Chelsea,22,1999,6.1,14,7,10,2,2,7,12,58.3,5,6,3,3,11,25,20,0,Matches
441,Dane Scarlett,eng ENG,MF,Tottenham,17,2004,0.0,0,0,0,0,0,0,0,,0,0,0,0,0,0,0,0,Matches
442,Fabian Schär,ch SUI,DF,Newcastle Utd,29,1991,24.0,16,11,11,3,2,8,16,50.0,8,27,18,9,32,48,95,2,Matches
443,Jeffrey Schlupp,gh GHA,"MF,FW",Crystal Palace,28,1992,20.6,46,25,16,23,7,24,50,48.0,26,39,9,30,18,64,32,0,Matches
444,Kasper Schmeichel,dk DEN,GK,Leicester City,34,1986,37.0,0,0,0,0,0,0,2,0.0,2,0,0,0,1,1,15,2,Matches
445,Ken Sema,se SWE,"MF,FW",Watford,27,1993,9.5,16,6,11,4,1,9,20,45.0,11,10,0,10,5,21,11,0,Matches
446,Nélson Semedo,pt POR,"MF,DF",Wolves,27,1993,23.7,58,39,39,17,2,25,49,51.0,24,23,4,19,21,79,64,1,Matches
447,Ryan Sessegnon,eng ENG,"DF,MF",Tottenham,21,2000,11.6,25,19,14,7,4,11,22,50.0,11,18,3,15,7,32,26,0,Matches
448,Jamie Shackleton,eng ENG,"DF,MF",Leeds United,21,1999,7.9,27,16,19,7,1,13,25,52.0,12,11,7,4,8,35,12,1,Matches
449,Luke Shaw,eng ENG,DF,Manchester Utd,26,1995,17.8,21,13,9,9,3,12,21,57.1,9,22,11,11,9,30,22,2,Matches
450,Jonjo Shelvey,eng ENG,MF,Newcastle Utd,29,1992,22.0,30,17,12,18,0,14,34,41.2,20,22,7,15,22,52,20,2,Matches
451,Shola Shoretire,eng ENG,MF,Manchester Utd,17,2004,0.2,0,0,0,0,0,0,0,,0,0,0,0,0,0,0,0,Matches
452,Francisco Sierralta,cl CHI,DF,Watford,24,1997,4.7,7,3,7,0,0,5,8,62.5,3,7,2,5,6,13,35,0,Matches
453,Bernardo Silva,pt POR,"MF,FW",Manchester City,26,1994,31.7,57,29,19,19,19,31,67,46.3,36,24,2,22,20,77,19,0,Matches
454,Fábio Silva,pt POR,FW,Wolves,19,2002,6.4,3,2,0,2,1,0,8,0.0,8,2,0,2,1,4,1,0,Matches
455,Thiago Silva,br BRA,DF,Chelsea,36,1984,29.4,32,21,19,12,1,11,22,50.0,11,54,31,23,44,76,100,0,Matches
456,Ellis Simms,eng ENG,FW,Everton,20,2001,0.7,0,0,0,0,0,0,0,,0,1,1,0,0,0,1,0,Matches
457,Moussa Sissoko,fr FRA,MF,Watford,31,1989,35.8,53,27,27,20,6,28,42,66.7,14,42,13,29,30,83,64,0,Matches
458,Oliver Skipp,eng ENG,MF,Tottenham,20,2000,15.0,33,19,14,18,1,15,31,48.4,16,19,7,12,12,45,10,1,Matches
459,William Smallbone,ie IRL,"MF,FW",Southampton,21,2000,1.5,4,4,2,2,0,1,3,33.3,2,4,0,4,2,6,0,0,Matches
460,Emile Smith Rowe,eng ENG,"MF,FW",Arsenal,21,2000,21.3,14,7,7,7,0,4,20,20.0,16,18,1,17,15,29,10,1,Matches
461,Cédric Soares,pt POR,DF,Arsenal,29,1991,16.5,38,26,23,9,6,16,25,64.0,9,18,7,11,16,54,31,1,Matches
462,Tomáš Souček,cz CZE,MF,West Ham,26,1995,34.0,66,32,27,33,6,28,65,43.1,37,34,13,21,52,118,98,1,Matches
463,Boubakary Soumaré,fr FRA,MF,Leicester City,22,1999,12.2,19,13,10,8,1,8,17,47.1,9,13,1,12,14,33,18,0,Matches
464,Çağlar Söyüncü,tr TUR,DF,Leicester City,25,1996,27.7,47,30,32,12,3,26,42,61.9,16,44,27,17,32,79,115,1,Matches
465,Tony Springett,ie IRL,"MF,FW",Norwich City,18,2002,1.6,2,1,1,1,0,1,4,25.0,3,0,0,0,0,2,2,0,Matches
466,Jason Steele,eng ENG,GK,Brighton,30,1990,1.0,0,0,0,0,0,0,0,,0,0,0,0,0,0,0,0,Matches
467,Jed Steer,eng ENG,GK,Aston Villa,28,1992,1.0,0,0,0,0,0,0,0,,0,0,0,0,0,0,0,0,Matches
468,Zack Steffen,us USA,GK,Manchester City,26,1995,1.0,0,0,0,0,0,0,0,,0,0,0,0,0,0,2,0,Matches
469,Dale Stephens,eng ENG,MF,Burnley,32,1989,1.4,4,1,0,3,1,3,8,37.5,5,4,1,3,1,5,1,0,Matches
470,Jack Stephens,eng ENG,DF,Southampton,27,1994,9.0,19,12,13,5,1,6,16,37.5,10,12,7,5,19,38,42,0,Matches
471,Raheem Sterling,eng ENG,FW,Manchester City,26,1994,23.6,23,10,3,11,9,10,23,43.5,13,12,0,12,12,35,3,0,Matches
472,Finley Stevens,wls WAL,DF,Brentford,18,2003,0.2,3,1,0,3,0,1,1,100.0,0,0,0,0,0,3,0,0,Matches
473,John Stones,eng ENG,DF,Manchester City,27,1994,12.4,5,3,3,2,0,2,3,66.7,1,3,3,0,11,16,27,1,Matches
474,Pascal Struijk,nl NED,"DF,MF",Leeds United,21,1999,22.8,61,39,34,23,4,30,50,60.0,20,35,23,12,33,94,60,2,Matches
475,Crysencio Summerville,nl NED,"MF,FW",Leeds United,19,2001,1.4,5,3,1,1,3,2,3,66.7,1,2,0,2,2,7,0,0,Matches
476,Jakob Sørensen,dk DEN,"MF,DF",Norwich City,23,1998,6.7,22,11,6,14,2,10,20,50.0,10,7,3,4,10,32,19,0,Matches
477,Japhet Tanganga,eng ENG,DF,Tottenham,22,1999,8.2,14,8,7,6,1,9,19,47.4,10,13,5,8,9,23,31,0,Matches
478,Matt Targett,eng ENG,DF,Aston Villa,25,1995,15.9,34,18,28,5,1,24,45,53.3,21,16,9,7,23,57,35,0,Matches
479,Matt Targett,eng ENG,DF,Newcastle Utd,25,1995,16.0,41,26,26,14,1,24,37,64.9,13,15,4,11,25,66,39,1,Matches
480,James Tarkowski,eng ENG,DF,Burnley,28,1992,34.5,65,45,47,17,1,33,47,70.2,14,75,61,14,48,113,186,4,Matches
481,Nuno Tavares,pt POR,DF,Arsenal,21,2000,13.1,21,14,10,7,4,8,18,44.4,10,15,5,10,9,30,33,1,Matches
482,Charlie Taylor,eng ENG,DF,Burnley,27,1993,30.3,45,26,31,11,3,26,44,59.1,18,42,20,22,58,103,95,2,Matches
483,Nathan Tella,ng NGA,"MF,FW",Southampton,22,1999,8.9,13,9,5,7,1,6,17,35.3,11,13,0,13,6,19,9,0,Matches
484,Alex Telles,br BRA,DF,Manchester Utd,28,1992,18.4,48,27,35,9,4,27,43,62.8,16,17,4,13,26,74,45,0,Matches
485,Luke Thomas,eng ENG,DF,Leicester City,20,2001,21.2,50,31,33,13,4,28,65,43.1,37,35,14,21,40,90,55,0,Matches
486,Dominic Thompson,eng ENG,DF,Brentford,21,2000,1.6,1,0,1,0,0,0,1,0.0,1,2,2,0,2,3,3,0,Matches
487,Youri Tielemans,be BEL,MF,Leicester City,24,1997,29.2,74,38,23,45,6,42,100,42.0,58,47,13,34,21,95,41,3,Matches
488,Kieran Tierney,sct SCO,DF,Arsenal,24,1997,21.3,18,14,11,7,0,10,11,90.9,1,23,5,18,15,33,54,0,Matches
489,Takehiro Tomiyasu,jp JPN,DF,Arsenal,22,1998,18.7,35,17,19,13,3,21,32,65.6,11,22,3,19,24,59,64,2,Matches
490,James Tomkins,eng ENG,DF,Crystal Palace,32,1989,6.1,8,3,6,2,0,6,8,75.0,2,8,8,0,4,12,18,0,Matches
491,Ivan Toney,eng ENG,FW,Brentford,25,1996,32.3,33,21,5,20,8,12,38,31.6,26,16,2,14,14,47,44,1,Matches
492,Ferrán Torres,es ESP,FW,Manchester City,21,2000,3.4,2,2,0,1,1,0,3,0.0,3,2,0,2,0,2,1,0,Matches
493,Cenk Tosun,tr TUR,MF,Everton,30,1991,0.1,0,0,0,0,0,0,0,,0,0,0,0,0,0,0,0,Matches
494,Andros Townsend,eng ENG,"MF,FW",Everton,30,1991,16.2,31,17,15,6,10,15,40,37.5,25,28,2,26,14,45,6,1,Matches
495,Adama Traoré,es ESP,"FW,MF",Wolves,25,1996,11.9,8,3,6,0,2,3,7,42.9,4,4,1,3,2,10,1,0,Matches
496,Bertrand Traoré,bf BFA,"MF,FW",Aston Villa,25,1995,2.4,3,3,0,1,2,1,2,50.0,1,0,0,0,0,3,1,0,Matches
497,Trézéguet,eg EGY,FW,Aston Villa,26,1994,0.1,0,0,0,0,0,0,0,,0,0,0,0,0,0,0,0,Matches
498,Francisco Trincão,pt POR,"FW,MF",Wolves,21,1999,14.8,28,15,9,13,6,3,19,15.8,16,17,1,16,12,40,1,1,Matches
499,Kieran Trippier,eng ENG,DF,Newcastle Utd,30,1990,4.8,17,10,8,8,1,10,16,62.5,6,10,3,7,10,27,10,0,Matches
500,William Troost-Ekong,ng NGA,DF,Watford,27,1993,15.4,18,9,11,6,1,10,15,66.7,5,24,14,10,7,25,82,1,Matches
501,Leandro Trossard,be BEL,"FW,MF",Brighton,26,1994,31.2,34,20,12,9,13,4,31,12.9,27,33,4,29,15,49,10,0,Matches
502,Kostas Tsimikas,gr GRE,DF,Liverpool,25,1996,9.7,27,12,12,8,7,12,16,75.0,4,6,2,4,10,37,22,2,Matches
503,Axel Tuanzebe,cd COD,DF,Aston Villa,23,1997,5.6,5,3,3,2,0,2,5,40.0,3,5,4,1,5,10,12,1,Matches
504,Ozan Tufan,tr TUR,MF,Watford,26,1995,3.7,3,2,1,1,1,1,5,20.0,4,2,0,2,2,5,4,0,Matches
505,Christos Tzolis,gr GRE,"FW,MF",Norwich City,19,2002,3.7,5,3,3,1,1,2,9,22.2,7,3,0,3,1,6,1,0,Matches
506,Yan Valery,tn TUN,DF,Southampton,22,1999,4.1,8,6,4,3,1,4,9,44.4,5,6,3,3,6,14,19,1,Matches
507,Virgil van Dijk,nl NED,DF,Liverpool,30,1991,34.0,16,10,11,5,0,11,16,68.8,5,21,14,7,31,47,109,0,Matches
508,Raphaël Varane,fr FRA,DF,Manchester Utd,28,1993,20.3,28,19,21,6,1,10,22,45.5,12,18,9,9,18,46,82,1,Matches
509,Jamie Vardy,eng ENG,FW,Leicester City,34,1987,20.1,6,5,0,4,2,1,7,14.3,6,9,0,9,1,7,17,0,Matches
510,Joël Veltman,nl NED,DF,Brighton,29,1992,31.9,74,48,47,21,6,21,53,39.6,32,46,16,30,45,119,89,0,Matches
511,Jannik Vestergaard,dk DEN,DF,Leicester City,28,1992,6.3,15,10,12,3,0,8,15,53.3,7,10,8,2,7,22,36,0,Matches
512,Nikola Vlašić,hr CRO,"FW,MF",West Ham,23,1997,6.2,11,7,4,6,1,5,20,25.0,15,4,0,4,2,13,1,0,Matches
513,Matěj Vydra,cz CZE,FW,Burnley,29,1992,7.5,12,7,3,4,5,3,7,42.9,4,5,1,4,0,12,9,0,Matches
514,Theo Walcott,eng ENG,"MF,FW",Southampton,32,1989,4.2,4,2,2,0,2,1,5,20.0,4,3,0,3,5,9,2,0,Matches
515,Kyle Walker,eng ENG,DF,Manchester City,31,1990,19.5,15,6,7,7,1,8,17,47.1,9,14,4,10,14,29,16,1,Matches
516,Kyle Walker-Peters,eng ENG,DF,Southampton,24,1997,29.3,57,33,28,21,8,26,38,68.4,12,29,8,21,37,94,53,1,Matches
517,Aaron Wan-Bissaka,eng ENG,DF,Manchester Utd,23,1997,19.9,49,36,25,18,6,14,20,70.0,6,24,14,10,34,83,41,2,Matches
518,Danny Ward,wls WAL,GK,Leicester City,28,1993,1.0,0,0,0,0,0,0,0,,0,0,0,0,0,0,1,0,Matches
519,Joel Ward,eng ENG,DF,Crystal Palace,31,1989,27.6,44,26,30,11,3,30,57,52.6,27,24,11,13,32,76,107,1,Matches
520,James Ward-Prowse,eng ENG,MF,Southampton,26,1994,35.7,41,24,12,24,5,19,70,27.1,51,43,15,28,40,81,45,1,Matches
521,Ollie Watkins,eng ENG,FW,Aston Villa,25,1995,32.8,17,13,2,7,8,2,15,13.3,13,25,3,22,12,29,27,0,Matches
522,Adam Webster,eng ENG,DF,Brighton,26,1995,15.9,26,8,17,7,2,13,20,65.0,7,25,17,8,17,43,66,2,Matches
523,Wout Weghorst,nl NED,FW,Burnley,28,1992,16.1,17,9,3,9,5,6,19,31.6,13,16,5,11,6,23,13,0,Matches
524,Danny Welbeck,eng ENG,"FW,MF",Brighton,30,1990,16.4,14,7,2,8,4,3,10,30.0,7,18,2,16,5,19,18,0,Matches
525,Timo Werner,de GER,"FW,MF",Chelsea,25,1996,14.3,8,4,3,3,2,2,20,10.0,18,9,0,9,2,10,4,0,Matches
526,Ashley Westwood,eng ENG,MF,Burnley,31,1990,25.4,21,12,8,12,1,10,31,32.3,21,21,9,12,30,51,16,1,Matches
527,Ben White,eng ENG,DF,Arsenal,23,1997,32.0,44,23,30,8,6,28,45,62.2,17,42,24,18,42,86,102,0,Matches
528,Brandon Williams,eng ENG,DF,Norwich City,20,2000,23.6,55,37,35,18,2,36,64,56.3,28,26,6,20,44,99,50,0,Matches
529,Neco Williams,wls WAL,DF,Liverpool,20,2001,0.1,0,0,0,0,0,0,0,,0,0,0,0,0,0,0,0,Matches
530,Joe Willock,eng ENG,MF,Newcastle Utd,21,1999,22.6,64,37,30,28,6,29,68,42.6,39,37,6,31,21,85,10,1,Matches
531,Callum Wilson,eng ENG,FW,Newcastle Utd,29,1992,15.4,9,8,1,5,3,1,4,25.0,3,7,2,5,3,12,10,0,Matches
532,Harry Winks,eng ENG,MF,Tottenham,25,1996,10.1,15,10,4,9,2,8,21,38.1,13,14,3,11,16,31,10,2,Matches
533,Yoane Wissa,cd COD,FW,Brentford,24,1996,14.3,12,6,5,4,3,1,16,6.3,15,12,5,7,8,20,6,0,Matches
534,Chris Wood,nz NZL,FW,Burnley,29,1991,15.2,7,5,0,3,4,3,10,30.0,7,13,4,9,0,7,3,0,Matches
535,Chris Wood,nz NZL,FW,Newcastle Utd,29,1991,14.7,2,0,1,1,0,1,2,50.0,1,5,2,3,2,4,9,0,Matches
536,Freddie Woodman,eng ENG,GK,Newcastle Utd,24,1997,4.0,0,0,0,0,0,0,0,,0,0,0,0,0,0,0,1,Matches
537,Granit Xhaka,ch SUI,"MF,DF",Arsenal,28,1992,25.9,32,18,16,12,4,16,41,39.0,25,21,6,15,21,53,31,0,Matches
538,Andriy Yarmolenko,ua UKR,"FW,MF",West Ham,31,1989,3.5,4,2,2,2,0,2,8,25.0,6,4,2,2,0,4,2,0,Matches
539,Ashley Young,eng ENG,"DF,FW",Aston Villa,36,1985,13.9,18,6,9,6,3,11,16,68.8,5,10,4,6,13,31,25,1,Matches
540,Nathan Young-Coombes,eng ENG,MF,Brentford,18,2003,0.0,0,0,0,0,0,0,0,,0,0,0,0,0,0,0,0,Matches
541,Wilfried Zaha,ci CIV,FW,Crystal Palace,28,1992,30.7,40,20,14,15,11,10,31,32.3,21,28,0,28,5,45,5,0,Matches
542,Christoph Zimmermann,de GER,DF,Norwich City,28,1993,1.7,6,3,5,1,0,3,4,75.0,1,0,0,0,1,7,4,0,Matches
543,Oleksandr Zinchenko,ua UKR,DF,Manchester City,24,1996,11.6,20,14,7,10,3,11,20,55.0,9,11,3,8,14,34,15,1,Matches
544,Hakim Ziyech,ma MAR,"MF,FW",Chelsea,28,1993,14.7,19,10,5,12,2,10,36,27.8,26,11,1,10,10,29,10,0,Matches
545,Kurt Zouma,fr FRA,DF,West Ham,26,1994,23.1,11,6,8,3,0,4,7,57.1,3,31,26,5,34,45,132,0,Matches
546,Martin Ødegaard,no NOR,"MF,FW",Arsenal,22,1998,30.9,49,21,6,24,19,22,61,36.1,39,18,1,17,11,60,11,1,Matches
